"aa" = (/turf/template_noop,/area/template_noop)
"ac" = (/turf/simulated/shuttle/wall/alien,/area/submap/cave/crashed_ufo)
"ad" = (/obj/structure/closet/alien,/turf/simulated/shuttle/floor/alienplating,/area/submap/cave/crashed_ufo)
"ae" = (/obj/structure/closet/alien,/obj/item/prop/alien/junk,/turf/simulated/shuttle/floor/alienplating,/area/submap/cave/crashed_ufo)
"af" = (/turf/simulated/shuttle/floor/alienplating,/area/submap/cave/crashed_ufo)
"ag" = (/obj/machinery/door/airlock/alien/locked,/turf/simulated/shuttle/floor/alienplating,/area/submap/cave/crashed_ufo)
"ah" = (/obj/effect/decal/remains/xeno,/turf/simulated/shuttle/floor/alienplating,/area/submap/cave/crashed_ufo)
"ai" = (/obj/machinery/porta_turret/alien,/turf/simulated/shuttle/floor/alienplating,/area/submap/cave/crashed_ufo)
"aj" = (/obj/structure/loot_pile/surface/alien/engineering,/turf/simulated/shuttle/floor/alienplating,/area/submap/cave/crashed_ufo)
"ak" = (/obj/structure/prop/alien/computer,/turf/simulated/shuttle/floor/alienplating,/area/submap/cave/crashed_ufo)
"al" = (/obj/item/weapon/tool/wrench/alien,/turf/simulated/shuttle/floor/alienplating,/area/submap/cave/crashed_ufo)
"am" = (/obj/structure/bed/alien,/turf/simulated/shuttle/floor/alienplating,/area/submap/cave/crashed_ufo)
"an" = (/obj/structure/table/alien,/turf/simulated/shuttle/floor/alien,/area/submap/cave/crashed_ufo)
"ao" = (/obj/structure/table/alien,/obj/item/clothing/head/helmet/alien,/turf/simulated/shuttle/floor/alienplating,/area/submap/cave/crashed_ufo)
"ap" = (/obj/structure/prop/alien/power,/turf/simulated/shuttle/floor/alienplating,/area/submap/cave/crashed_ufo)
"aq" = (/turf/simulated/shuttle/floor/alien,/area/submap/cave/crashed_ufo)
"ar" = (/obj/structure/table/alien,/obj/item/weapon/paper/alien{icon_state = "alienpaper_words"; info = "\[i]This tablet has a large collection of symbols that you've never seen before outside this ship. You have no hope of figuring out what any of the mean...\[/i]"},/turf/simulated/shuttle/floor/alienplating,/area/submap/cave/crashed_ufo)
"as" = (/turf/simulated/shuttle/wall/alien/hard_corner,/area/submap/cave/crashed_ufo)
"at" = (/obj/structure/prop/alien/computer,/turf/simulated/shuttle/floor/alien,/area/submap/cave/crashed_ufo)
"au" = (/obj/structure/table/alien,/obj/item/prop/alien/junk,/turf/simulated/shuttle/floor/alien,/area/submap/cave/crashed_ufo)
"av" = (/obj/structure/table/alien,/obj/item/weapon/paper/alien{icon_state = "alienpaper_words"; info = "\[i]This tablet has a large collection of symbols that you've never seen before outside this ship. You have no hope of figuring out what any of the mean...\[/i]"},/turf/simulated/shuttle/floor/alien,/area/submap/cave/crashed_ufo)
"aw" = (/obj/structure/loot_pile/surface/alien/security,/turf/simulated/shuttle/floor/alienplating,/area/submap/cave/crashed_ufo)
"ax" = (/obj/structure/prop/alien/computer{dir = 8},/turf/simulated/shuttle/floor/alien,/area/submap/cave/crashed_ufo)
"ay" = (/obj/structure/prop/alien/computer{icon_state = "console-c"; dir = 4},/turf/simulated/shuttle/floor/alienplating,/area/submap/cave/crashed_ufo)
"az" = (/obj/machinery/door/airlock/alien/locked{welded = 1},/turf/simulated/shuttle/floor/alienplating,/area/submap/cave/crashed_ufo)
"aA" = (/obj/structure/bed/alien,/obj/effect/decal/remains/xeno,/turf/simulated/shuttle/floor/alienplating,/area/submap/cave/crashed_ufo)
"aB" = (/obj/item/weapon/tool/screwdriver/alien,/turf/simulated/shuttle/floor/alienplating,/area/submap/cave/crashed_ufo)
"aC" = (/obj/item/weapon/tool/wirecutters/alien,/turf/simulated/shuttle/floor/alienplating,/area/submap/cave/crashed_ufo)
"aD" = (/obj/structure/table/alien,/turf/simulated/shuttle/floor/alienplating,/area/submap/cave/crashed_ufo)
"aE" = (/obj/item/device/multitool/alien,/turf/simulated/shuttle/floor/alienplating,/area/submap/cave/crashed_ufo)
"aF" = (/obj/structure/prop/alien/computer/camera/flipped{icon_state = "camera_flipped"; dir = 4},/turf/simulated/shuttle/floor/alien,/area/submap/cave/crashed_ufo)
"aG" = (/obj/structure/prop/alien/computer/camera{icon_state = "camera"; dir = 8},/turf/simulated/shuttle/floor/alien,/area/submap/cave/crashed_ufo)
"aH" = (/obj/machinery/porta_turret/alien,/turf/simulated/shuttle/floor/alien,/area/submap/cave/crashed_ufo)
"aI" = (/obj/machinery/door/airlock/alien/locked{p_open = 1},/turf/simulated/shuttle/floor/alienplating,/area/submap/cave/crashed_ufo)
"aJ" = (/obj/effect/decal/remains/robot,/turf/simulated/shuttle/floor/alienplating,/area/submap/cave/crashed_ufo)
"aK" = (/obj/item/weapon/tool/crowbar/alien,/turf/simulated/shuttle/floor/alienplating,/area/submap/cave/crashed_ufo)
"aL" = (/obj/item/stack/cable_coil/alien,/turf/simulated/shuttle/floor/alienplating,/area/submap/cave/crashed_ufo)
"aM" = (/obj/structure/table/alien,/obj/item/prop/alien/junk,/turf/simulated/shuttle/floor/alienplating,/area/submap/cave/crashed_ufo)
"aN" = (/obj/structure/table/alien,/obj/item/weapon/paper/alien{icon_state = "alienpaper_words"; info = "\[i]This tablet has a large collection of symbols that you've never seen before outside this ship. You have no hope of figuring out what any of the mean...\[/i]"},/obj/item/device/gps/internal/poi,/turf/simulated/shuttle/floor/alienplating,/area/submap/cave/crashed_ufo)
"aO" = (/obj/structure/prop/alien/computer{icon_state = "console-c"; dir = 4},/turf/simulated/shuttle/floor/alien,/area/submap/cave/crashed_ufo)
"aP" = (/obj/structure/table/alien,/obj/item/clothing/accessory/medal/dungeon/alien_ufo,/turf/simulated/shuttle/floor/alienplating,/area/submap/cave/crashed_ufo)
"aQ" = (/obj/structure/table/alien,/obj/item/weapon/weldingtool/alien,/turf/simulated/shuttle/floor/alienplating,/area/submap/cave/crashed_ufo)
"aR" = (/obj/structure/bed/alien,/turf/simulated/shuttle/floor/alien,/area/submap/cave/crashed_ufo)
"aS" = (/obj/structure/prop/alien/computer/camera,/turf/simulated/shuttle/floor/alien,/area/submap/cave/crashed_ufo)
"aT" = (/obj/structure/closet/alien,/obj/item/weapon/paper/alien,/turf/simulated/shuttle/floor/alien,/area/submap/cave/crashed_ufo)
"aU" = (/obj/structure/bed/alien,/obj/effect/decal/remains/xeno,/turf/simulated/shuttle/floor/alien,/area/submap/cave/crashed_ufo)
"aV" = (/obj/structure/loot_pile/surface/alien/end,/turf/simulated/shuttle/floor/alienplating,/area/submap/cave/crashed_ufo)
"aW" = (/obj/structure/table/alien,/obj/item/weapon/surgical/circular_saw/alien,/turf/simulated/shuttle/floor/alien,/area/submap/cave/crashed_ufo)
"aX" = (/obj/structure/table/alien,/obj/item/weapon/surgical/FixOVein/alien,/turf/simulated/shuttle/floor/alien,/area/submap/cave/crashed_ufo)
"aY" = (/obj/structure/table/alien,/obj/item/weapon/surgical/scalpel/alien,/turf/simulated/shuttle/floor/alien,/area/submap/cave/crashed_ufo)
"aZ" = (/obj/item/weapon/surgical/hemostat/alien,/turf/simulated/shuttle/floor/alien,/area/submap/cave/crashed_ufo)
"ba" = (/obj/machinery/door/airlock/alien/locked,/turf/simulated/shuttle/floor/alien,/area/submap/cave/crashed_ufo)
"bb" = (/obj/effect/decal/remains/lizard,/turf/simulated/shuttle/floor/alien,/area/submap/cave/crashed_ufo)
"bc" = (/obj/structure/prop/alien/dispenser,/turf/simulated/shuttle/floor/alien,/area/submap/cave/crashed_ufo)
"bd" = (/obj/structure/table/alien,/obj/item/weapon/surgical/bone_clamp/alien,/turf/simulated/shuttle/floor/alien,/area/submap/cave/crashed_ufo)
"be" = (/obj/structure/loot_pile/surface/alien/medical,/turf/simulated/shuttle/floor/alienplating,/area/submap/cave/crashed_ufo)
"bf" = (/obj/structure/closet/alien,/obj/item/prop/alien/junk,/turf/simulated/shuttle/floor/alien,/area/submap/cave/crashed_ufo)
"bg" = (/obj/structure/prop/alien/dispenser,/turf/simulated/shuttle/floor/alienplating,/area/submap/cave/crashed_ufo)
"bh" = (/obj/effect/decal/remains/mouse,/turf/simulated/shuttle/floor/alien,/area/submap/cave/crashed_ufo)
"bi" = (/obj/structure/closet/alien,/obj/item/prop/alien/junk,/obj/item/prop/alien/junk,/turf/simulated/shuttle/floor/alienplating,/area/submap/cave/crashed_ufo)

(1,1,1) = {"
aaaaaaaaaaaaaaaaaaaaaaaaaaaaaaaaaaaaaaaaaaaaaaaaaaaaaaaaaaaaaaaaaa
aaaaaaaaaaaaaaaaaaaaaaaaaaacacacacacacacaaaaaaaaaaaaaaaaaaaaaaaaaa
aaaaaaaaaaaaaaaaaaaaacacacacadadaeadadacacacacaaaaaaaaaaaaaaaaaaaa
aaaaaaaaaaaaaaaaacacacafagafafafahafafafagafacacacaaaaaaaaaaaaaaaa
aaaaaaaaaaaaaaacacafafafacafafafafafafafacafafafacacaaaaaaaaaaaaaa
aaaaaaaaaaaaacacafafacacacacaiafafafaiacacacacafafacacaaaaaaaaaaaa
aaaaaaaaaaacacafafacacajakacacafafalacacamahacacafafacacaaaaaaaaaa
aaaaaaaaacacafafacacaiafafanacacafacacaoafahaeacacafafacacaaaaaaaa
aaaaaaacacafafacacapafafaqanarasagasacacagacacacacacafafacacaaaaaa
aaaaaaacafafacacapafafaqaqaqafasafasaiaqaqatauauacacacafafacaaaaaa
aaaaacacafacacaiafafaqaqaqafafagafagafafaqaqaqavacaeacacafacacaaaa
aaaaacafafacajafafaqaqaqafafajasafasawafafaqaqaxacafahacafafacaaaa
aaaaacagacacayafaqaqaqafafadacasazasacawafafaqaqagafaAacacagacaaaa
aaacacafafacacananaqaBaCadacacatafatacacawafafaqacaDacacafafacacaa
aaacadafafaiacacaDaEahajacacaFaqafaqaGacacawafaHacacacaiafafaeacaa
aaacadafafafafacasasaIasacaqaqaqaJaqaqaqacasagasasacafafafaKadacaa
aaacaeafaLafafafagafafafacaiaqaMaNaraqaiacafafafagafafafafafadacaa
aaacaeafafafafacasasagasacaOaqaPahaQaqaxacasagasasacahafafafaeacaa
aaacadafafaiacacatacaqaRacacaqaqaqaqaqacacaSaqaqaTacacaiafafadacaa
aaacacafafacacaqaqacaqaqaUacacaiaVaiacacaWaqaqaqacacacacafafacacaa
aaaaacagacacaXaqaUasacaqaqaRacacacacacaYaHaqaqasacaZacacacagacaaaa
aaaaacafafacavaqaqbaaqaqaqaqaUasafasaFaqaqaqaqbaaqbbaqacafafacaaaa
aaaaacacafacacbcbdasaiaqacaqaqagafagaqaqaqaqaqasacaqacacafacacaaaa
aaaaaaacafafacacacacasagasacacasafasaqaqasbaasacacacacafafacaaaaaa
aaaaaaacacafafacacacbeafafafbeasagasbfacacaqacacacacafafacacaaaaaa
aaaaaaaaacacafafacacbgafafbeacacafacacacaqbhaqacacafafacacaaaaaaaa
aaaaaaaaaaacacafafacacbibeacacafafafacacacaqacacafafacacaaaaaaaaaa
aaaaaaaaaaaaacacafafacacacacaiafafafaiacacacacafafacacaaaaaaaaaaaa
aaaaaaaaaaaaaaacacafafafasafafafafafafafasafafafacacaaaaaaaaaaaaaa
aaaaaaaaaaaaaaaaacacacafagafafafafafafafagafacacacaaaaaaaaaaaaaaaa
aaaaaaaaaaaaaaaaaaaaacacasacafasagasafacasacacaaaaaaaaaaaaaaaaaaaa
aaaaaaaaaaaaaaaaaaaaaaaaaaacasasafasacacaaaaaaaaaaaaaaaaaaaaaaaaaa
aaaaaaaaaaaaaaaaaaaaaaaaaaaaaaasagasaaaaaaaaaaaaaaaaaaaaaaaaaaaaaa
aaaaaaaaaaaaaaaaaaaaaaaaaaaaaaaaaaaaaaaaaaaaaaaaaaaaaaaaaaaaaaaaaa
"}
