"aa" = (/turf/template_noop,/area/template_noop)
"ab" = (/obj/effect/decal/cleanable/blood/oil,/turf/template_noop,/area/template_noop)
"ac" = (/obj/structure/grille,/obj/item/weapon/material/shard{icon_state = "medium"},/turf/simulated/mineral/floor/ignore_mapgen/vacuum,/area/template_noop)
"ad" = (/turf/simulated/mineral/floor/ignore_mapgen/vacuum,/area/submap/shuttles/containment4)
"ae" = (/obj/structure/girder,/turf/simulated/floor/plating,/area/submap/shuttles/containment4)
"af" = (/turf/simulated/mineral/floor/ignore_mapgen/vacuum,/area/template_noop)
"ag" = (/turf/simulated/shuttle/wall/dark/hard_corner,/area/submap/shuttles/containment4)
"ah" = (/turf/simulated/shuttle/wall/dark,/area/submap/shuttles/containment4)
"ai" = (/obj/structure/lattice,/turf/simulated/mineral/floor/ignore_mapgen/vacuum,/area/submap/shuttles/containment4)
"aj" = (/obj/structure/girder,/turf/simulated/floor/plating,/area/template_noop)
"ak" = (/obj/item/weapon/material/shard{icon_state = "medium"},/turf/simulated/mineral/floor/ignore_mapgen/vacuum,/area/template_noop)
"al" = (/turf/simulated/shuttle/wall/dark/hard_corner,/area/template_noop)
"am" = (/obj/item/stack/rods,/turf/simulated/shuttle/floor/black/airless,/area/submap/shuttles/containment4)
"an" = (/obj/structure/door_assembly/door_assembly_ext,/turf/simulated/mineral/floor/ignore_mapgen/vacuum,/area/submap/shuttles/containment4)
"ao" = (/obj/structure/door_assembly/door_assembly_ext{anchored = 1},/turf/simulated/shuttle/plating/airless,/area/submap/shuttles/containment4)
"ap" = (/obj/structure/grille,/obj/item/weapon/material/shard,/turf/simulated/shuttle/plating/airless,/area/submap/shuttles/containment4)
"aq" = (/obj/structure/loot_pile/maint/technical,/turf/simulated/mineral/floor/ignore_mapgen/vacuum,/area/submap/shuttles/containment4)
"ar" = (/obj/structure/grille{density = 0; icon_state = "brokengrille"},/obj/structure/lattice,/turf/simulated/mineral/floor/ignore_mapgen/vacuum,/area/submap/shuttles/containment4)
"as" = (/obj/structure/girder,/turf/simulated/shuttle/plating/airless,/area/submap/shuttles/containment4)
"at" = (/obj/structure/shuttle/engine/propulsion{dir = 8},/turf/simulated/mineral/floor/ignore_mapgen/vacuum,/area/submap/shuttles/containment4)
"au" = (/obj/item/weapon/circuitboard/broken,/turf/simulated/mineral/floor/ignore_mapgen/vacuum,/area/submap/shuttles/containment4)
"av" = (/turf/simulated/shuttle/floor/black/airless,/area/submap/shuttles/containment4)
"aw" = (/turf/simulated/shuttle/plating/airless,/area/submap/shuttles/containment4)
"ax" = (/obj/effect/decal/cleanable/blood/oil,/turf/simulated/shuttle/floor/black/airless,/area/submap/shuttles/containment4)
"ay" = (/obj/effect/decal/mecha_wreckage/gygax{anchored = 1},/turf/simulated/shuttle/floor/black/airless,/area/submap/shuttles/containment4)
"az" = (/obj/structure/loot_pile/maint/technical,/turf/simulated/shuttle/floor/black/airless,/area/submap/shuttles/containment4)
"aA" = (/turf/simulated/shuttle/wall/dark,/area/template_noop)
"aB" = (/obj/structure/shuttle/engine/heater{dir = 8},/obj/structure/window/reinforced{dir = 4; health = 1e+006},/turf/template_noop,/area/submap/shuttles/containment4)
"aC" = (/obj/effect/decal/remains/robot,/turf/simulated/mineral/floor/ignore_mapgen/vacuum,/area/submap/shuttles/containment4)
"aD" = (/obj/structure/lattice,/turf/simulated/mineral/floor/ignore_mapgen/vacuum,/area/template_noop)
"aE" = (/obj/effect/decal/cleanable/blood/drip,/turf/simulated/shuttle/floor/black/airless,/area/submap/shuttles/containment4)
"aF" = (/obj/structure/table/steel_reinforced,/turf/simulated/shuttle/floor/black/airless,/area/submap/shuttles/containment4)
"aG" = (/obj/structure/closet/medical_wall,/turf/simulated/shuttle/wall/dark,/area/submap/shuttles/containment4)
"aH" = (/turf/simulated/shuttle/floor/yellow/airless,/area/submap/shuttles/containment4)
"aI" = (/obj/structure/loot_pile/maint/technical,/turf/simulated/shuttle/floor/yellow/airless,/area/submap/shuttles/containment4)
"aJ" = (/obj/structure/door_assembly/door_assembly_highsecurity{anchored = 1},/turf/simulated/shuttle/floor/black/airless,/area/submap/shuttles/containment4)
"aK" = (/obj/structure/closet/walllocker/emerglocker/east,/turf/simulated/shuttle/floor/black/airless,/area/submap/shuttles/containment4)
"aL" = (/obj/structure/grille,/obj/item/weapon/material/shard{icon_state = "medium"},/turf/simulated/shuttle/plating/airless,/area/submap/shuttles/containment4)
"aM" = (/obj/item/weapon/circuitboard/broken,/turf/simulated/shuttle/floor/black/airless,/area/submap/shuttles/containment4)
"aN" = (/obj/structure/reagent_dispensers/fueltank,/turf/simulated/shuttle/floor/red/airless,/area/submap/shuttles/containment4)
"aO" = (/turf/simulated/shuttle/floor/red/airless,/area/submap/shuttles/containment4)
"aP" = (/obj/random/drinkbottle,/obj/random/drinkbottle,/obj/random/drinkbottle,/obj/random/drinkbottle,/obj/random/drinkbottle,/obj/random/drinkbottle,/obj/structure/closet/crate,/turf/simulated/shuttle/floor/red/airless,/area/submap/shuttles/containment4)
"aQ" = (/obj/structure/bed/chair/office/dark{dir = 4},/obj/effect/decal/cleanable/blood/oil,/turf/simulated/shuttle/floor/yellow/airless,/area/submap/shuttles/containment4)
"aR" = (/obj/structure/frame/computer,/turf/simulated/shuttle/floor/yellow/airless,/area/submap/shuttles/containment4)
"aS" = (/obj/structure/frame,/obj/item/weapon/circuitboard/broken,/turf/simulated/shuttle/floor/black/airless,/area/submap/shuttles/containment4)
"aT" = (/obj/effect/decal/cleanable/vomit,/turf/simulated/shuttle/floor/black/airless,/area/submap/shuttles/containment4)
"aU" = (/obj/effect/decal/cleanable/blood/oil,/obj/structure/closet/crate,/obj/random/multiple/gun/projectile/rifle,/turf/simulated/shuttle/floor/red/airless,/area/submap/shuttles/containment4)
"aV" = (/obj/effect/decal/cleanable/blood/oil,/turf/simulated/shuttle/floor/red/airless,/area/submap/shuttles/containment4)
"aW" = (/obj/item/weapon/circuitboard/broken,/obj/structure/bed/chair/office/dark{dir = 4},/turf/simulated/shuttle/floor/yellow/airless,/area/submap/shuttles/containment4)
"aX" = (/turf/simulated/shuttle/wall/dark/no_join,/area/submap/shuttles/containment4)
"aY" = (/obj/effect/decal/remains/robot,/turf/simulated/shuttle/floor/red/airless,/area/submap/shuttles/containment4)
"aZ" = (/obj/effect/decal/cleanable/blood/oil,/obj/structure/largecrate,/obj/random/multiple/gun/projectile/shotgun,/obj/random/multiple/gun/projectile/shotgun,/turf/simulated/shuttle/floor/red/airless,/area/submap/shuttles/containment4)
"ba" = (/obj/effect/decal/remains/human,/obj/effect/decal/cleanable/blood/oil,/turf/simulated/shuttle/floor/red/airless,/area/submap/shuttles/containment4)
"bb" = (/obj/item/weapon/material/shard,/obj/effect/decal/cleanable/blood/oil,/turf/simulated/floor/plating,/area/submap/shuttles/containment4)
"bc" = (/obj/effect/decal/cleanable/blood/drip,/obj/effect/decal/cleanable/blood/drip,/obj/effect/decal/cleanable/blood/drip,/turf/simulated/shuttle/floor/yellow/airless,/area/submap/shuttles/containment4)
"bd" = (/obj/machinery/computer,/turf/simulated/shuttle/floor/yellow/airless,/area/submap/shuttles/containment4)
"be" = (/obj/structure/grille{density = 0; icon_state = "brokengrille"},/obj/item/stack/rods,/turf/simulated/shuttle/plating/airless,/area/submap/shuttles/containment4)
"bf" = (/turf/simulated/floor/outdoors/rocks/airless,/area/template_noop)
"bg" = (/obj/effect/decal/cleanable/blood/drip,/obj/effect/decal/cleanable/blood/drip,/obj/effect/decal/cleanable/blood/oil,/turf/simulated/shuttle/floor/black/airless,/area/submap/shuttles/containment4)
"bh" = (/obj/structure/extinguisher_cabinet,/turf/simulated/shuttle/wall/dark,/area/submap/shuttles/containment4)
"bi" = (/obj/structure/grille,/obj/item/weapon/material/shard{icon_state = "medium"},/turf/simulated/floor/plating,/area/submap/shuttles/containment4)
"bj" = (/obj/structure/bed/chair/office/dark{dir = 4},/turf/simulated/shuttle/floor/yellow/airless,/area/submap/shuttles/containment4)
"bk" = (/obj/item/stack/rods,/turf/simulated/shuttle/plating/airless,/area/submap/shuttles/containment4)
"bl" = (/obj/item/weapon/material/shard,/turf/simulated/mineral/floor/ignore_mapgen/vacuum,/area/template_noop)
"bm" = (/obj/item/stack/rods,/turf/simulated/mineral/floor/ignore_mapgen/vacuum,/area/template_noop)
"bn" = (/obj/structure/door_assembly,/turf/simulated/shuttle/floor/white,/area/submap/shuttles/containment4)
"bo" = (/obj/structure/table/steel_reinforced,/turf/simulated/shuttle/floor/yellow/airless,/area/submap/shuttles/containment4)
"bp" = (/obj/structure/shuttle/engine/propulsion{dir = 8},/turf/simulated/mineral/floor/ignore_mapgen/vacuum,/area/template_noop)
"bq" = (/obj/effect/decal/cleanable/blood/drip,/obj/effect/decal/cleanable/blood/drip,/turf/simulated/shuttle/floor/white,/area/submap/shuttles/containment4)
"br" = (/obj/structure/loot_pile/maint/technical,/turf/simulated/shuttle/floor/white,/area/submap/shuttles/containment4)
"bs" = (/obj/effect/decal/cleanable/blood/drip,/turf/simulated/shuttle/floor/white,/area/submap/shuttles/containment4)
"bt" = (/obj/structure/closet/walllocker/emerglocker/north,/obj/structure/frame,/obj/item/weapon/circuitboard/broken,/turf/simulated/shuttle/floor/white,/area/submap/shuttles/containment4)
"bu" = (/obj/structure/frame,/turf/simulated/shuttle/floor/black/airless,/area/submap/shuttles/containment4)
"bv" = (/obj/item/frame/mirror,/obj/item/weapon/material/shard{icon_state = "medium"},/turf/simulated/shuttle/wall/dark,/area/submap/shuttles/containment4)
"bw" = (/obj/structure/sink{icon_state = "sink"; dir = 8; pixel_x = -12; pixel_y = 2},/obj/effect/decal/cleanable/blood/drip,/obj/effect/decal/cleanable/blood/drip,/turf/simulated/shuttle/floor/white,/area/submap/shuttles/containment4)
"bx" = (/turf/simulated/shuttle/floor/white,/area/submap/shuttles/containment4)
"by" = (/obj/effect/decal/cleanable/vomit,/turf/simulated/shuttle/floor/white,/area/submap/shuttles/containment4)
"bz" = (/obj/structure/toilet{dir = 8},/turf/simulated/shuttle/floor/white,/area/submap/shuttles/containment4)
"bA" = (/obj/structure/shuttle/engine/heater{dir = 8},/obj/structure/window/reinforced{dir = 4; health = 1e+006},/turf/simulated/mineral/floor/ignore_mapgen/vacuum,/area/submap/shuttles/containment4)
"bB" = (/obj/structure/door_assembly/door_assembly_ext{anchored = 1},/turf/simulated/mineral/floor/ignore_mapgen/vacuum,/area/submap/shuttles/containment4)
"bC" = (/obj/item/weapon/circuitboard/broken,/turf/simulated/mineral/floor/ignore_mapgen/vacuum,/area/template_noop)
"bD" = (/obj/structure/grille,/obj/item/weapon/material/shard,/turf/simulated/floor/plating,/area/submap/shuttles/containment4)
"bE" = (/obj/item/clothing/suit/space/cult,/turf/simulated/mineral/floor/ignore_mapgen/vacuum,/area/template_noop)
"bF" = (/obj/structure/bed/chair/office/dark{dir = 8},/turf/simulated/mineral/floor/ignore_mapgen/vacuum,/area/template_noop)
"bG" = (/obj/effect/decal/cleanable/blood/oil,/turf/simulated/floor/outdoors/rocks/airless,/area/template_noop)
"bH" = (/obj/effect/decal/cleanable/blood/oil,/turf/simulated/mineral/floor/ignore_mapgen/vacuum,/area/template_noop)
"bI" = (/obj/item/weapon/material/shard,/turf/template_noop,/area/template_noop)
"bJ" = (/turf/simulated/shuttle/plating/airless,/area/template_noop)
"bK" = (/obj/structure/grille{density = 0; icon_state = "brokengrille"},/obj/item/weapon/material/shard{icon_state = "medium"},/obj/item/stack/rods,/turf/simulated/shuttle/plating/airless,/area/template_noop)
"bL" = (/obj/effect/decal/cleanable/liquid_fuel,/turf/template_noop,/area/template_noop)
"bM" = (/obj/effect/decal/cleanable/blood/drip,/turf/template_noop,/area/template_noop)
"bN" = (/obj/structure/shuttle/engine/propulsion{icon_state = "burst_r"},/turf/simulated/mineral/floor/ignore_mapgen/vacuum,/area/template_noop)
"bO" = (/obj/structure/loot_pile/maint/technical,/turf/simulated/mineral/floor/ignore_mapgen/vacuum,/area/template_noop)
"bP" = (/obj/effect/decal/cleanable/liquid_fuel,/turf/simulated/mineral/floor/ignore_mapgen/vacuum,/area/template_noop)
"bQ" = (/turf/simulated/shuttle/floor/black/airless,/area/template_noop)
"bR" = (/obj/item/weapon/circuitboard/broken,/turf/simulated/shuttle/floor/black/airless,/area/template_noop)
"bS" = (/obj/effect/decal/cleanable/liquid_fuel,/obj/item/weapon/flame/lighter/random,/turf/simulated/mineral/floor/ignore_mapgen/vacuum,/area/template_noop)

(1,1,1) = {"
aaaaaaaaaaaaaaaaaaaaaaaaaaaaaaabaaaaaaaaaaaaaaaaaa
aaababaaaaaaaaabaaaaaaaaaaaaaaaaaaaaabaaaaaaabaaaa
aaaaaaabaaaaaaacaaaaaaafajaaaaaaaaaaaaaaakaaaaaaaa
aaaaalaAaaaaaaaaaaabaaaaaDaabfbfaablaaaaaaaaaaabaa
aaaaaAaaaaafabaaabaaafaDbfbfbfafbfaaaaabbmaaaaaaaa
aaafaaaaamanaoapahahaqarahahasasahagaaaaabaaaaabaa
aabpbCaaavawaaavavadauavavaxayavazahagaaaaaaaaaaaa
aabEaaaBahaaavavaCaiavavavavaEavaFahasawaaabaaaaaa
aaaaafafafaiaiaiavavavaxavavamavaFaGaHaIasaaaabmaa
aAaaaaaaaiavamavavavahahaJahaeavaKahaHaHaHaLaaaaaa
bfafataBahavavaxaMavahaNaOaPahavavavaHaQaRapaaaaaa
aabfafaaahaSavaTavaEahaUaOaVahaMavaJaHaWaRawaDaaaa
bfaXataBahazavaEavaEaeaYaZbaaeavaEbbaHbcbdbeaabFaa
bfbfaaaaaaaabgavavavaeahahahbhavavbiaHbjaRawaaacaa
bfbfafabbkaiavavavbGbfavavavavavavahaHaHaHaLaaaaaa
bHaaabaaaaawavavbGbfbfavahaeahbnahahaIboahahaaaaaa
bfaAaaaabIaiavazbfbGaEavaGbqbrbsbtahahahagbfaaaaaa
bfbfaabfahavavavavavavbubvbwbxbybzasagbfbfaaaaaaaa
aaaabCbAaaahbBaibJbKasaeaeahahbDasagbfbfaaaaaaaaaa
aAaaabaabfbfaabJaaaaaDaDbfbfbfaDbfbfaaaaaaaaaaabaa
aabCaaabaaaAaaaaafaaaabLaabMaaaaaaaaaaabaaabaaaaaa
aabNaaaaaabOaaaaaaaabPbLbMaabLaaaaaaaaaaaaaaaaaaaa
aaaaaaabaaaabQbRaaaabLafbSbLbLaaabaaaaaaabaaaaaaaa
aaabafafaaaaaaaAbfbPbLbLbLaaafaaaaaaaaaaaaabaaaaaa
aaaaaaafaaaaaabfbfaaaaaabLaaaaaaaaaaaaaaaaaaaaaaaa
"}
