"aa" = (/turf/template_noop,/area/template_noop)
"ab" = (/obj/effect/decal/cleanable/blood/oil,/turf/template_noop,/area/template_noop)
"ac" = (/obj/structure/grille,/obj/item/weapon/material/shard{icon_state = "medium"},/turf/simulated/mineral/floor/ignore_mapgen/vacuum,/area/template_noop)
"ad" = (/turf/simulated/mineral/floor/ignore_mapgen/vacuum,/area/submap/shuttles/containment5)
"ae" = (/obj/structure/girder,/turf/simulated/floor/plating,/area/submap/shuttles/containment5)
"af" = (/turf/simulated/mineral/floor/ignore_mapgen/vacuum,/area/template_noop)
"ag" = (/turf/simulated/shuttle/wall/dark/hard_corner,/area/submap/shuttles/containment5)
"ah" = (/turf/simulated/shuttle/wall/dark,/area/submap/shuttles/containment5)
"ai" = (/obj/structure/lattice,/turf/simulated/mineral/floor/ignore_mapgen/vacuum,/area/submap/shuttles/containment5)
"aj" = (/turf/simulated/floor/outdoors/rocks/airless,/area/submap/shuttles/containment5)
"ak" = (/obj/structure/girder,/turf/simulated/floor/plating,/area/template_noop)
"al" = (/obj/item/weapon/material/shard{icon_state = "medium"},/turf/simulated/mineral/floor/ignore_mapgen/vacuum,/area/template_noop)
"am" = (/obj/item/stack/rods,/turf/simulated/shuttle/floor/black/airless,/area/submap/shuttles/containment5)
"an" = (/obj/structure/door_assembly/door_assembly_ext,/turf/simulated/mineral/floor/ignore_mapgen/vacuum,/area/submap/shuttles/containment5)
"ao" = (/obj/structure/door_assembly/door_assembly_ext{anchored = 1},/turf/simulated/shuttle/plating/airless,/area/submap/shuttles/containment5)
"ap" = (/obj/structure/grille,/obj/item/weapon/material/shard,/turf/simulated/shuttle/plating/airless,/area/submap/shuttles/containment5)
"aq" = (/obj/structure/loot_pile/maint/technical,/turf/simulated/mineral/floor/ignore_mapgen/vacuum,/area/submap/shuttles/containment5)
"ar" = (/obj/structure/grille{density = 0; icon_state = "brokengrille"},/obj/structure/lattice,/turf/simulated/mineral/floor/ignore_mapgen/vacuum,/area/submap/shuttles/containment5)
"as" = (/obj/structure/girder,/turf/simulated/shuttle/plating/airless,/area/submap/shuttles/containment5)
"at" = (/turf/simulated/shuttle/wall/dark/hard_corner,/area/template_noop)
"au" = (/obj/item/weapon/circuitboard/broken,/turf/simulated/mineral/floor/ignore_mapgen/vacuum,/area/submap/shuttles/containment5)
"av" = (/turf/simulated/shuttle/floor/black/airless,/area/submap/shuttles/containment5)
"aw" = (/turf/simulated/shuttle/plating/airless,/area/submap/shuttles/containment5)
"ax" = (/obj/effect/decal/cleanable/blood/oil,/turf/simulated/shuttle/floor/black/airless,/area/submap/shuttles/containment5)
"ay" = (/obj/effect/decal/mecha_wreckage/gygax{anchored = 1},/turf/simulated/shuttle/floor/black/airless,/area/submap/shuttles/containment5)
"az" = (/obj/structure/loot_pile/maint/technical,/turf/simulated/shuttle/floor/black/airless,/area/submap/shuttles/containment5)
"aA" = (/turf/simulated/shuttle/wall/dark,/area/template_noop)
"aB" = (/obj/structure/shuttle/engine/heater{dir = 8},/obj/structure/window/reinforced{dir = 4; health = 1e+006},/turf/template_noop,/area/submap/shuttles/containment5)
"aC" = (/obj/effect/decal/remains/robot,/turf/simulated/mineral/floor/ignore_mapgen/vacuum,/area/submap/shuttles/containment5)
"aD" = (/obj/structure/lattice,/turf/simulated/mineral/floor/ignore_mapgen/vacuum,/area/template_noop)
"aE" = (/obj/effect/decal/cleanable/blood/drip,/turf/simulated/shuttle/floor/black/airless,/area/submap/shuttles/containment5)
"aF" = (/obj/structure/table/steel_reinforced,/turf/simulated/shuttle/floor/black/airless,/area/submap/shuttles/containment5)
"aG" = (/obj/structure/closet/medical_wall,/turf/simulated/shuttle/wall/dark,/area/submap/shuttles/containment5)
"aH" = (/turf/simulated/shuttle/floor/yellow/airless,/area/submap/shuttles/containment5)
"aI" = (/obj/structure/loot_pile/maint/technical,/turf/simulated/shuttle/floor/yellow/airless,/area/submap/shuttles/containment5)
"aJ" = (/obj/structure/door_assembly/door_assembly_highsecurity{anchored = 1},/turf/simulated/shuttle/floor/black/airless,/area/submap/shuttles/containment5)
"aK" = (/obj/structure/closet/walllocker/emerglocker/east,/turf/simulated/shuttle/floor/black/airless,/area/submap/shuttles/containment5)
"aL" = (/obj/structure/grille,/obj/item/weapon/material/shard{icon_state = "medium"},/turf/simulated/shuttle/plating/airless,/area/submap/shuttles/containment5)
"aM" = (/obj/item/weapon/circuitboard/broken,/turf/simulated/shuttle/floor/black/airless,/area/submap/shuttles/containment5)
"aN" = (/obj/random/drinkbottle,/obj/random/drinkbottle,/turf/simulated/shuttle/floor/red/airless,/area/submap/shuttles/containment5)
"aO" = (/turf/simulated/shuttle/floor/red/airless,/area/submap/shuttles/containment5)
"aP" = (/obj/structure/closet/crate,/obj/random/toy,/obj/random/toy,/obj/random/toy,/obj/random/toy,/obj/random/toy,/obj/random/toy,/obj/random/toy,/obj/random/toy,/turf/simulated/shuttle/floor/red/airless,/area/submap/shuttles/containment5)
"aQ" = (/obj/structure/bed/chair/office/dark{dir = 4},/obj/effect/decal/cleanable/blood/oil,/turf/simulated/shuttle/floor/yellow/airless,/area/submap/shuttles/containment5)
"aR" = (/obj/structure/frame/computer,/turf/simulated/shuttle/floor/yellow/airless,/area/submap/shuttles/containment5)
"aS" = (/obj/structure/frame,/obj/item/weapon/circuitboard/broken,/turf/simulated/shuttle/floor/black/airless,/area/submap/shuttles/containment5)
"aT" = (/obj/effect/decal/cleanable/vomit,/turf/simulated/shuttle/floor/black/airless,/area/submap/shuttles/containment5)
"aU" = (/obj/effect/decal/cleanable/blood/oil,/obj/random/drinksoft,/turf/simulated/shuttle/floor/red/airless,/area/submap/shuttles/containment5)
"aV" = (/obj/structure/largecrate,/obj/random/mech_toy,/obj/random/mech_toy,/obj/random/mech_toy,/obj/random/mech_toy,/obj/random/mech_toy,/obj/random/mech_toy,/turf/simulated/shuttle/floor/red/airless,/area/submap/shuttles/containment5)
"aW" = (/obj/effect/decal/cleanable/blood/oil,/turf/simulated/shuttle/floor/red/airless,/area/submap/shuttles/containment5)
"aX" = (/obj/item/weapon/circuitboard/broken,/obj/structure/bed/chair/office/dark{dir = 4},/turf/simulated/shuttle/floor/yellow/airless,/area/submap/shuttles/containment5)
"aY" = (/turf/simulated/floor/outdoors/rocks/airless,/area/template_noop)
"aZ" = (/obj/effect/decal/remains/robot,/turf/simulated/shuttle/floor/red/airless,/area/submap/shuttles/containment5)
"ba" = (/obj/effect/decal/cleanable/blood/oil,/obj/random/drinkbottle,/turf/simulated/shuttle/floor/red/airless,/area/submap/shuttles/containment5)
"bb" = (/obj/effect/decal/remains/human,/obj/effect/decal/cleanable/blood/oil,/turf/simulated/shuttle/floor/red/airless,/area/submap/shuttles/containment5)
"bc" = (/obj/item/weapon/material/shard,/obj/effect/decal/cleanable/blood/oil,/turf/simulated/floor/plating,/area/submap/shuttles/containment5)
"bd" = (/obj/effect/decal/cleanable/blood/drip,/obj/effect/decal/cleanable/blood/drip,/obj/effect/decal/cleanable/blood/drip,/turf/simulated/shuttle/floor/yellow/airless,/area/submap/shuttles/containment5)
"be" = (/obj/machinery/computer,/turf/simulated/shuttle/floor/yellow/airless,/area/submap/shuttles/containment5)
"bf" = (/obj/structure/grille{density = 0; icon_state = "brokengrille"},/obj/item/stack/rods,/turf/simulated/shuttle/plating/airless,/area/submap/shuttles/containment5)
"bg" = (/obj/item/weapon/material/shard,/turf/simulated/mineral/floor/ignore_mapgen/vacuum,/area/template_noop)
"bh" = (/obj/effect/decal/cleanable/blood/drip,/obj/effect/decal/cleanable/blood/drip,/obj/effect/decal/cleanable/blood/oil,/turf/simulated/shuttle/floor/black/airless,/area/submap/shuttles/containment5)
"bi" = (/obj/random/toolbox,/turf/simulated/shuttle/floor/black/airless,/area/submap/shuttles/containment5)
"bj" = (/obj/structure/extinguisher_cabinet,/turf/simulated/shuttle/wall/dark,/area/submap/shuttles/containment5)
"bk" = (/obj/structure/grille,/obj/item/weapon/material/shard{icon_state = "medium"},/turf/simulated/floor/plating,/area/submap/shuttles/containment5)
"bl" = (/obj/structure/bed/chair/office/dark{dir = 4},/turf/simulated/shuttle/floor/yellow/airless,/area/submap/shuttles/containment5)
"bm" = (/obj/item/stack/rods,/turf/simulated/shuttle/plating/airless,/area/submap/shuttles/containment5)
"bn" = (/obj/item/stack/rods,/turf/simulated/mineral/floor/ignore_mapgen/vacuum,/area/template_noop)
"bo" = (/obj/structure/shuttle/engine/propulsion{dir = 8},/turf/simulated/mineral/floor/ignore_mapgen/vacuum,/area/template_noop)
"bp" = (/obj/structure/door_assembly,/turf/simulated/shuttle/floor/white,/area/submap/shuttles/containment5)
"bq" = (/obj/structure/table/steel_reinforced,/obj/random/plushie,/turf/simulated/shuttle/floor/yellow/airless,/area/submap/shuttles/containment5)
"br" = (/obj/item/weapon/circuitboard/broken,/turf/simulated/mineral/floor/ignore_mapgen/vacuum,/area/template_noop)
"bs" = (/obj/effect/decal/cleanable/blood/drip,/obj/effect/decal/cleanable/blood/drip,/turf/simulated/shuttle/floor/white,/area/submap/shuttles/containment5)
"bt" = (/obj/structure/loot_pile/maint/technical,/turf/simulated/shuttle/floor/white,/area/submap/shuttles/containment5)
"bu" = (/obj/effect/decal/cleanable/blood/drip,/turf/simulated/shuttle/floor/white,/area/submap/shuttles/containment5)
"bv" = (/obj/structure/closet/walllocker/emerglocker/north,/obj/structure/frame,/obj/item/weapon/circuitboard/broken,/turf/simulated/shuttle/floor/white,/area/submap/shuttles/containment5)
"bw" = (/obj/structure/frame,/turf/simulated/shuttle/floor/black/airless,/area/submap/shuttles/containment5)
"bx" = (/obj/item/frame/mirror,/obj/item/weapon/material/shard{icon_state = "medium"},/turf/simulated/shuttle/wall/dark,/area/submap/shuttles/containment5)
"by" = (/obj/structure/sink{icon_state = "sink"; dir = 8; pixel_x = -12; pixel_y = 2},/obj/effect/decal/cleanable/blood/drip,/obj/effect/decal/cleanable/blood/drip,/turf/simulated/shuttle/floor/white,/area/submap/shuttles/containment5)
"bz" = (/turf/simulated/shuttle/floor/white,/area/submap/shuttles/containment5)
"bA" = (/obj/effect/decal/cleanable/vomit,/turf/simulated/shuttle/floor/white,/area/submap/shuttles/containment5)
"bB" = (/obj/structure/toilet{dir = 8},/obj/random/plushielarge,/turf/simulated/shuttle/floor/white,/area/submap/shuttles/containment5)
"bC" = (/obj/structure/shuttle/engine/heater{dir = 8},/obj/structure/window/reinforced{dir = 4; health = 1e+006},/turf/simulated/mineral/floor/ignore_mapgen/vacuum,/area/submap/shuttles/containment5)
"bD" = (/obj/structure/door_assembly/door_assembly_ext{anchored = 1},/turf/simulated/mineral/floor/ignore_mapgen/vacuum,/area/submap/shuttles/containment5)
"bE" = (/obj/structure/grille{density = 0; icon_state = "brokengrille"},/obj/item/weapon/material/shard{icon_state = "medium"},/obj/item/stack/rods,/turf/simulated/shuttle/plating/airless,/area/submap/shuttles/containment5)
"bF" = (/obj/structure/grille,/obj/item/weapon/material/shard,/turf/simulated/floor/plating,/area/submap/shuttles/containment5)
"bG" = (/obj/item/clothing/suit/space/cult,/turf/simulated/mineral/floor/ignore_mapgen/vacuum,/area/template_noop)
"bH" = (/turf/simulated/shuttle/wall/dark/no_join,/area/template_noop)
"bI" = (/obj/structure/bed/chair/office/dark{dir = 8},/turf/simulated/mineral/floor/ignore_mapgen/vacuum,/area/template_noop)
"bJ" = (/obj/effect/decal/cleanable/blood/oil,/turf/simulated/floor/outdoors/rocks/airless,/area/template_noop)
"bK" = (/obj/effect/decal/cleanable/blood/oil,/turf/simulated/mineral/floor/ignore_mapgen/vacuum,/area/template_noop)
"bL" = (/obj/item/weapon/material/shard,/turf/template_noop,/area/template_noop)
"bM" = (/turf/simulated/shuttle/plating/airless,/area/template_noop)
"bN" = (/obj/effect/decal/cleanable/liquid_fuel,/turf/template_noop,/area/template_noop)
"bO" = (/obj/effect/decal/cleanable/blood/drip,/turf/template_noop,/area/template_noop)
"bP" = (/obj/structure/shuttle/engine/propulsion{icon_state = "burst_r"},/turf/simulated/mineral/floor/ignore_mapgen/vacuum,/area/template_noop)
"bQ" = (/obj/structure/loot_pile/maint/technical,/turf/simulated/mineral/floor/ignore_mapgen/vacuum,/area/template_noop)
"bR" = (/obj/effect/decal/cleanable/liquid_fuel,/turf/simulated/mineral/floor/ignore_mapgen/vacuum,/area/template_noop)
"bS" = (/turf/simulated/shuttle/floor/black/airless,/area/template_noop)
"bT" = (/obj/item/weapon/circuitboard/broken,/turf/simulated/shuttle/floor/black/airless,/area/template_noop)
"bU" = (/obj/effect/decal/cleanable/liquid_fuel,/obj/item/weapon/flame/lighter/random,/turf/simulated/mineral/floor/ignore_mapgen/vacuum,/area/template_noop)

(1,1,1) = {"
aaaaaaaaaaaaaaaaaaaaaaaaaaaaaaabaaaaaaaaaaaaaaaaaa
aaababaaaaaaaaabaaaaaaaaaaaaaaaaaaaaabaaaaaaabaaaa
aaaaaaabaaaaaaacaaaaaaafakaaaaaaaaaaaaaaalaaaaaaaa
aaaaataAaaaaaaaaaaabaaaaaDaaaYaYaabgaaaaaaaaaaabaa
aaaaaAaaaaafabaaabaaafaDaYaYaYafaYaaaaabbnaaaaaaaa
aaafaaaaamanaoapahahaqarahahasasahagaaaaabaaaaabaa
aabobraaavawaaavavadauavavaxayavazahagaaaaaaaaaaaa
aabGaaaBahaaavavaCaiavavavavaEavaFahasawaaabaaaaaa
aaaaafafafaiaiaiavavavaxavavamavaFaGaHaIasaaaabnaa
aAaaaaaaaiavamavavavahahaJahaeavaKahaHaHaHaLaaaaaa
aYafboaBahavavaxaMavahaNaOaPahavavavaHaQaRapaaaaaa
aaaYafaaahaSavaTavaEahaUaVaWahaMavaJaHaXaRawaDaaaa
aYbHboaBahazavaEavaEaeaZbabbaeavaEbcaHbdbebfaabIaa
aYaYaaaaaaaabhavbiavaeahahahbjavavbkaHblaRawaaacaa
aYaYafabbmaiavavavbJaYavavavavavavahaHaHaHaLaaaaaa
bKaaabaaaaawavavbJaYaYavahaeahbpahahaIbqahahaaaaaa
aYaAaaaabLaDavazaYbJaEavaGbsbtbubvahahahagajaaaaaa
aYaYaaaYahavavavavavavbwbxbybzbAbBasagaYaYaaaaaaaa
aaaabrbCaaahbDaiawbEasaeaeahahbFasagaYaYaaaaaaaaaa
aAaaabaaaYaYaabMaaaaaDaDaYaYaYaDaYaYaaaaaaaaaaabaa
aabraaabaaaAaaaaafaaaabNaabOaaaaaaaaaaabaaabaaaaaa
aabPaaaaaabQaaaaaaaabRbNbOaabNaaaaaaaaaaaaaaaaaaaa
aaaaaaabaaaabSbTaaaabNafbUbNbNaaabaaaaaaabaaaaaaaa
aaabafafaaaaaaaAaYbRbNbNbNaaafaaaaaaaaaaaaabaaaaaa
aaaaaaafaaaaaaaYaYaaaaaabNaaaaaaaaaaaaaaaaaaaaaaaa
"}
