"aa" = (/turf/template_noop,/area/submap/shuttles/containment2)
"ab" = (/turf/template_noop,/area/template_noop)
"ac" = (/obj/effect/decal/cleanable/blood/oil,/turf/template_noop,/area/template_noop)
"ad" = (/obj/structure/grille,/obj/item/weapon/material/shard{icon_state = "medium"},/turf/simulated/mineral/floor/ignore_mapgen/vacuum,/area/template_noop)
"ae" = (/obj/structure/girder,/turf/simulated/floor/plating,/area/submap/shuttles/containment2)
"af" = (/turf/simulated/mineral/floor/ignore_mapgen/vacuum,/area/template_noop)
"ag" = (/turf/simulated/shuttle/wall/dark/hard_corner,/area/submap/shuttles/containment2)
"ah" = (/turf/simulated/shuttle/wall/dark,/area/submap/shuttles/containment2)
"ai" = (/obj/structure/lattice,/turf/simulated/mineral/floor/ignore_mapgen/vacuum,/area/submap/shuttles/containment2)
"aj" = (/turf/simulated/floor/outdoors/rocks/airless,/area/submap/shuttles/containment2)
"ak" = (/obj/structure/girder,/turf/simulated/floor/plating,/area/template_noop)
"al" = (/obj/item/weapon/material/shard{icon_state = "medium"},/turf/simulated/mineral/floor/ignore_mapgen/vacuum,/area/template_noop)
"am" = (/obj/item/stack/rods,/turf/simulated/shuttle/floor/black/airless,/area/submap/shuttles/containment2)
"an" = (/obj/structure/door_assembly/door_assembly_ext,/turf/simulated/mineral/floor/ignore_mapgen/vacuum,/area/submap/shuttles/containment2)
"ao" = (/obj/structure/door_assembly/door_assembly_ext{anchored = 1},/turf/simulated/shuttle/plating/airless,/area/submap/shuttles/containment2)
"ap" = (/obj/structure/grille,/obj/item/weapon/material/shard,/turf/simulated/shuttle/plating/airless,/area/submap/shuttles/containment2)
"aq" = (/turf/simulated/shuttle/wall/dark/hard_corner,/area/template_noop)
"ar" = (/obj/structure/grille{density = 0; icon_state = "brokengrille"},/obj/structure/lattice,/turf/simulated/mineral/floor/ignore_mapgen/vacuum,/area/submap/shuttles/containment2)
"as" = (/obj/structure/girder,/turf/simulated/shuttle/plating/airless,/area/submap/shuttles/containment2)
"at" = (/turf/simulated/shuttle/wall/dark,/area/template_noop)
"au" = (/obj/structure/lattice,/turf/simulated/mineral/floor/ignore_mapgen/vacuum,/area/template_noop)
"av" = (/turf/simulated/shuttle/floor/black/airless,/area/submap/shuttles/containment2)
"aw" = (/turf/simulated/shuttle/plating/airless,/area/submap/shuttles/containment2)
"ax" = (/obj/effect/decal/cleanable/blood/oil,/turf/simulated/shuttle/floor/black/airless,/area/submap/shuttles/containment2)
"ay" = (/obj/effect/decal/mecha_wreckage/gygax{anchored = 1},/turf/simulated/shuttle/floor/black/airless,/area/submap/shuttles/containment2)
"az" = (/obj/structure/loot_pile/maint/technical,/turf/simulated/shuttle/floor/black/airless,/area/submap/shuttles/containment2)
"aA" = (/turf/simulated/floor/outdoors/rocks/airless,/area/template_noop)
"aB" = (/obj/item/weapon/material/shard,/turf/simulated/mineral/floor/ignore_mapgen/vacuum,/area/template_noop)
"aC" = (/obj/item/stack/rods,/turf/simulated/mineral/floor/ignore_mapgen/vacuum,/area/template_noop)
"aD" = (/obj/structure/loot_pile/maint/technical,/turf/simulated/mineral/floor/ignore_mapgen/vacuum,/area/template_noop)
"aE" = (/obj/effect/decal/cleanable/blood/drip,/turf/simulated/shuttle/floor/black/airless,/area/submap/shuttles/containment2)
"aF" = (/obj/structure/table/steel_reinforced,/turf/simulated/shuttle/floor/black/airless,/area/submap/shuttles/containment2)
"aG" = (/obj/structure/closet/medical_wall,/turf/simulated/shuttle/wall/dark,/area/submap/shuttles/containment2)
"aH" = (/turf/simulated/shuttle/floor/yellow/airless,/area/submap/shuttles/containment2)
"aI" = (/obj/structure/loot_pile/maint/technical,/turf/simulated/shuttle/floor/yellow/airless,/area/submap/shuttles/containment2)
"aJ" = (/obj/structure/door_assembly/door_assembly_highsecurity{anchored = 1},/turf/simulated/shuttle/floor/black/airless,/area/submap/shuttles/containment2)
"aK" = (/obj/structure/closet/walllocker/emerglocker/east,/turf/simulated/shuttle/floor/black/airless,/area/submap/shuttles/containment2)
"aL" = (/obj/structure/grille,/obj/item/weapon/material/shard{icon_state = "medium"},/turf/simulated/shuttle/plating/airless,/area/submap/shuttles/containment2)
"aM" = (/obj/item/weapon/circuitboard/broken,/turf/simulated/shuttle/floor/black/airless,/area/submap/shuttles/containment2)
"aN" = (/obj/structure/reagent_dispensers/fueltank,/turf/simulated/shuttle/floor/red/airless,/area/submap/shuttles/containment2)
"aO" = (/turf/simulated/shuttle/floor/red/airless,/area/submap/shuttles/containment2)
"aP" = (/obj/structure/closet/crate{name = "landmines crate"; opened = 1},/obj/random/landmine,/obj/random/landmine,/obj/random/landmine,/obj/random/landmine,/obj/random/landmine,/obj/random/landmine,/obj/random/landmine,/obj/random/landmine,/turf/simulated/shuttle/floor/red/airless,/area/submap/shuttles/containment2)
"aQ" = (/obj/structure/bed/chair/office/dark{dir = 4},/obj/effect/decal/cleanable/blood/oil,/turf/simulated/shuttle/floor/yellow/airless,/area/submap/shuttles/containment2)
"aR" = (/obj/structure/frame/computer,/turf/simulated/shuttle/floor/yellow/airless,/area/submap/shuttles/containment2)
"aS" = (/obj/structure/frame,/obj/item/weapon/circuitboard/broken,/turf/simulated/shuttle/floor/black/airless,/area/submap/shuttles/containment2)
"aT" = (/obj/effect/decal/cleanable/vomit,/turf/simulated/shuttle/floor/black/airless,/area/submap/shuttles/containment2)
"aU" = (/obj/effect/decal/cleanable/blood/oil,/turf/simulated/shuttle/floor/red/airless,/area/submap/shuttles/containment2)
"aV" = (/obj/structure/largecrate,/obj/random/firstaid,/obj/random/firstaid,/obj/random/firstaid,/obj/random/firstaid,/obj/random/firstaid,/turf/simulated/shuttle/floor/red/airless,/area/submap/shuttles/containment2)
"aW" = (/obj/effect/decal/remains/human,/obj/effect/decal/cleanable/blood/oil,/turf/simulated/shuttle/floor/red/airless,/area/submap/shuttles/containment2)
"aX" = (/obj/item/weapon/circuitboard/broken,/obj/structure/bed/chair/office/dark{dir = 4},/turf/simulated/shuttle/floor/yellow/airless,/area/submap/shuttles/containment2)
"aY" = (/obj/structure/shuttle/engine/propulsion{dir = 8},/turf/simulated/mineral/floor/ignore_mapgen/vacuum,/area/template_noop)
"aZ" = (/obj/effect/decal/remains/robot,/turf/simulated/shuttle/floor/red/airless,/area/submap/shuttles/containment2)
"ba" = (/obj/item/weapon/circuitboard/broken,/turf/simulated/mineral/floor/ignore_mapgen/vacuum,/area/template_noop)
"bb" = (/obj/item/weapon/material/shard,/obj/effect/decal/cleanable/blood/oil,/turf/simulated/floor/plating,/area/submap/shuttles/containment2)
"bc" = (/obj/effect/decal/cleanable/blood/drip,/obj/effect/decal/cleanable/blood/drip,/obj/effect/decal/cleanable/blood/drip,/turf/simulated/shuttle/floor/yellow/airless,/area/submap/shuttles/containment2)
"bd" = (/obj/machinery/computer,/turf/simulated/shuttle/floor/yellow/airless,/area/submap/shuttles/containment2)
"be" = (/obj/structure/grille{density = 0; icon_state = "brokengrille"},/obj/item/stack/rods,/turf/simulated/shuttle/plating/airless,/area/submap/shuttles/containment2)
"bf" = (/obj/item/clothing/suit/space/cult,/turf/simulated/mineral/floor/ignore_mapgen/vacuum,/area/template_noop)
"bg" = (/obj/effect/decal/cleanable/blood/drip,/obj/effect/decal/cleanable/blood/drip,/obj/effect/decal/cleanable/blood/oil,/turf/simulated/shuttle/floor/black/airless,/area/submap/shuttles/containment2)
"bh" = (/obj/structure/extinguisher_cabinet,/turf/simulated/shuttle/wall/dark,/area/submap/shuttles/containment2)
"bi" = (/obj/structure/grille,/obj/item/weapon/material/shard{icon_state = "medium"},/turf/simulated/floor/plating,/area/submap/shuttles/containment2)
"bj" = (/obj/structure/bed/chair/office/dark{dir = 4},/turf/simulated/shuttle/floor/yellow/airless,/area/submap/shuttles/containment2)
"bk" = (/obj/item/stack/rods,/turf/simulated/shuttle/plating/airless,/area/submap/shuttles/containment2)
"bl" = (/obj/effect/decal/cleanable/blood/oil,/turf/simulated/floor/outdoors/rocks/airless,/area/submap/shuttles/containment2)
"bm" = (/obj/structure/shuttle/engine/heater{dir = 8},/obj/structure/window/reinforced{dir = 4; health = 1e+006},/turf/template_noop,/area/template_noop)
"bn" = (/obj/structure/door_assembly,/turf/simulated/shuttle/floor/white,/area/submap/shuttles/containment2)
"bo" = (/obj/structure/table/steel_reinforced,/turf/simulated/shuttle/floor/yellow/airless,/area/submap/shuttles/containment2)
"bp" = (/obj/effect/decal/remains/robot,/turf/simulated/mineral/floor/ignore_mapgen/vacuum,/area/template_noop)
"bq" = (/obj/effect/decal/cleanable/blood/drip,/obj/effect/decal/cleanable/blood/drip,/turf/simulated/shuttle/floor/white,/area/submap/shuttles/containment2)
"br" = (/obj/structure/loot_pile/maint/technical,/turf/simulated/shuttle/floor/white,/area/submap/shuttles/containment2)
"bs" = (/obj/effect/decal/cleanable/blood/drip,/turf/simulated/shuttle/floor/white,/area/submap/shuttles/containment2)
"bt" = (/obj/structure/closet/walllocker/emerglocker/north,/obj/structure/frame,/obj/item/weapon/circuitboard/broken,/turf/simulated/shuttle/floor/white,/area/submap/shuttles/containment2)
"bu" = (/obj/structure/frame,/turf/simulated/shuttle/floor/black/airless,/area/submap/shuttles/containment2)
"bv" = (/obj/item/frame/mirror,/obj/item/weapon/material/shard{icon_state = "medium"},/turf/simulated/shuttle/wall/dark,/area/submap/shuttles/containment2)
"bw" = (/obj/structure/sink{icon_state = "sink"; dir = 8; pixel_x = -12; pixel_y = 2},/obj/effect/decal/cleanable/blood/drip,/obj/effect/decal/cleanable/blood/drip,/turf/simulated/shuttle/floor/white,/area/submap/shuttles/containment2)
"bx" = (/turf/simulated/shuttle/floor/white,/area/submap/shuttles/containment2)
"by" = (/obj/effect/decal/cleanable/vomit,/turf/simulated/shuttle/floor/white,/area/submap/shuttles/containment2)
"bz" = (/obj/structure/toilet{dir = 8},/turf/simulated/shuttle/floor/white,/area/submap/shuttles/containment2)
"bA" = (/turf/simulated/shuttle/wall/dark/no_join,/area/template_noop)
"bB" = (/obj/structure/door_assembly/door_assembly_ext{anchored = 1},/turf/simulated/mineral/floor/ignore_mapgen/vacuum,/area/submap/shuttles/containment2)
"bC" = (/obj/structure/grille{density = 0; icon_state = "brokengrille"},/obj/item/weapon/material/shard{icon_state = "medium"},/obj/item/stack/rods,/turf/simulated/shuttle/plating/airless,/area/submap/shuttles/containment2)
"bD" = (/obj/structure/grille,/obj/item/weapon/material/shard,/turf/simulated/floor/plating,/area/submap/shuttles/containment2)
"bE" = (/obj/structure/bed/chair/office/dark{dir = 8},/turf/simulated/mineral/floor/ignore_mapgen/vacuum,/area/template_noop)
"bF" = (/obj/effect/decal/cleanable/blood/oil,/turf/simulated/mineral/floor/ignore_mapgen/vacuum,/area/template_noop)
"bG" = (/turf/simulated/shuttle/plating/airless,/area/template_noop)
"bH" = (/obj/item/weapon/material/shard,/turf/template_noop,/area/template_noop)
"bI" = (/obj/structure/shuttle/engine/heater{dir = 8},/obj/structure/window/reinforced{dir = 4; health = 1e+006},/turf/simulated/mineral/floor/ignore_mapgen/vacuum,/area/template_noop)
"bJ" = (/obj/effect/decal/cleanable/liquid_fuel,/turf/template_noop,/area/template_noop)
"bK" = (/obj/effect/decal/cleanable/blood/drip,/turf/template_noop,/area/template_noop)
"bL" = (/obj/structure/shuttle/engine/propulsion{icon_state = "burst_r"},/turf/simulated/mineral/floor/ignore_mapgen/vacuum,/area/template_noop)
"bM" = (/obj/effect/decal/cleanable/liquid_fuel,/turf/simulated/mineral/floor/ignore_mapgen/vacuum,/area/template_noop)
"bN" = (/turf/simulated/shuttle/floor/black/airless,/area/template_noop)
"bO" = (/obj/item/weapon/circuitboard/broken,/turf/simulated/shuttle/floor/black/airless,/area/template_noop)
"bP" = (/obj/effect/decal/cleanable/liquid_fuel,/obj/item/weapon/flame/lighter/random,/turf/simulated/mineral/floor/ignore_mapgen/vacuum,/area/template_noop)

(1,1,1) = {"
abababababababababababababababacababababababababab
abacacababababacababababababababababacabababacabab
abababacabababadabababafakabababababababalabababab
ababaqatabababababacababauabaAaAabaBabababababacab
ababatababafacabacabafauaAaAaAafaAababacaCabababab
abafababamanaoapahahaDarahahasasahagababacababacab
abaYbaabavawaaavavafbaavavaxayavazahagabababababab
abbfabbmahaaavavbpauavavavavaEavaFahasawabacababab
ababafafafauauauavavavaxavavamavaFaGaHaIasababaCab
atabababaiavamavavavahahaJahaeavaKahaHaHaHaLababab
aAafaYbmahavavaxaMavahaNaOaPahavavavaHaQaRapababab
abaAafabahaSavaTavaEahaUaVaUahaMavaJaHaXaRawauabab
aAbAaYbmahazavaEavaEaeaZaUaWaeavaEbbaHbcbdbeabbEab
aAaAababababbgavavavaeahahahbhavavbiaHbjaRawabadab
aAaAafacbkaiavavavblajavavavavavavahaHaHaHaLababab
bFabacababbGavavblajajavahaeahbnahahaIboahahababab
aAatababbHauavazajblaEavaGbqbrbsbtahahahagaAababab
aAaAabaAahavavavavavavbubvbwbxbybzasagaAaAabababab
ababbabIabahbBaiawbCasaeaeahahbDasagaAaAababababab
atabacabaAaAabbGababauauaAaAaAauaAaAabababababacab
abbaabacabatababafababbJabbKabababababacabacababab
abbLabababaDababababbMbJbKabbJabababababababababab
abababacababbNbOababbJafbPbJbJabacabababacabababab
abacafafabababataAbMbJbJbJabafababababababacababab
abababafabababaAaAabababbJabababababababababababab
"}
