"a" = (/turf/template_noop,/area/template_noop)
"b" = (/obj/structure/shuttle/engine/propulsion/burst{dir = 1},/turf/simulated/shuttle/wall,/area/submap/wreckage/escape_pods4)
"c" = (/obj/structure/door_assembly/door_assembly_ext,/turf/simulated/shuttle/floor,/area/submap/wreckage/escape_pods4)
"d" = (/turf/simulated/shuttle/wall,/area/submap/wreckage/escape_pods4)
"e" = (/obj/structure/bed/chair,/obj/item/device/radio/intercom{dir = 8; name = "Station Intercom (General)"; pixel_x = -28},/obj/structure/closet/walllocker/emerglocker{pixel_x = 28},/obj/item/weapon/weldingtool,/obj/item/weapon/airlock_electronics,/turf/simulated/shuttle/floor,/area/submap/wreckage/escape_pods4)
"f" = (/obj/structure/shuttle/engine/propulsion/burst{icon_state = "propulsion"; dir = 4},/turf/simulated/shuttle/wall,/area/submap/wreckage/escape_pods4)
"g" = (/obj/structure/bed/chair,/obj/machinery/vending/wallmed1{layer = 3.3; name = "Emergency NanoMed"; pixel_x = 28; pixel_y = 0},/obj/machinery/light{dir = 8; icon_state = "tube1"; pixel_y = 0},/turf/simulated/shuttle/floor,/area/submap/wreckage/escape_pods4)
"h" = (/obj/structure/shuttle/window,/obj/structure/grille,/turf/simulated/shuttle/plating,/area/submap/wreckage/escape_pods4)
"i" = (/obj/structure/bed/chair{icon_state = "chair_preview"; dir = 8},/obj/effect/decal/cleanable/dirt,/obj/machinery/status_display{pixel_y = -32},/obj/item/device/radio/intercom{dir = 1; name = "Station Intercom (General)"; pixel_y = 21},/turf/simulated/shuttle/floor,/area/submap/wreckage/escape_pods4)
"j" = (/obj/structure/bed/chair{icon_state = "chair_preview"; dir = 8},/obj/structure/loot_pile/surface/medicine_cabinet{pixel_y = 28},/obj/machinery/light,/obj/effect/decal/cleanable/blood/drip,/obj/effect/decal/cleanable/dirt,/obj/effect/decal/cleanable/blood/drip,/obj/item/weapon/reagent_containers/hypospray/autoinjector/empty,/turf/simulated/shuttle/floor,/area/submap/wreckage/escape_pods4)
"k" = (/obj/structure/bed/chair{icon_state = "chair_preview"; dir = 8},/obj/structure/closet/walllocker/emerglocker{pixel_y = 28},/obj/effect/decal/cleanable/dirt,/obj/effect/decal/cleanable/blood/drip,/obj/item/weapon/airlock_electronics,/turf/simulated/shuttle/floor,/area/submap/wreckage/escape_pods4)
"l" = (/obj/effect/decal/cleanable/blood/drip,/obj/machinery/door/airlock/external{icon_state = "door_locked"; locked = 1; name = "Escape Pod Hatch"},/turf/simulated/shuttle/floor,/area/submap/wreckage/escape_pods4)
"m" = (/obj/structure/bed/chair,/obj/machinery/status_display{density = 0; layer = 4; pixel_x = -32; pixel_y = 0},/obj/item/weapon/storage/backpack/satchel,/obj/item/weapon/spacecash/c100,/turf/simulated/shuttle/floor,/area/submap/wreckage/escape_pods4)
"n" = (/obj/structure/bed/chair,/obj/item/device/radio/intercom{dir = 8; name = "Station Intercom (General)"; pixel_x = -28},/obj/structure/closet/walllocker/emerglocker{pixel_x = 28},/obj/item/weapon/weldingtool,/turf/simulated/shuttle/floor,/area/submap/wreckage/escape_pods4)
"o" = (/obj/structure/grille{density = 0; icon_state = "brokengrille"},/obj/structure/window/reinforced{dir = 1; health = 1e+006},/obj/structure/window/reinforced,/obj/item/stack/rods,/obj/item/weapon/material/shard,/obj/item/weapon/material/shard{icon_state = "medium"},/turf/simulated/shuttle/plating,/area/submap/wreckage/escape_pods4)
"p" = (/obj/structure/bed/chair{icon_state = "chair_preview"; dir = 8},/obj/structure/loot_pile/surface/bones,/obj/effect/decal/cleanable/blood,/obj/effect/decal/cleanable/dirt,/obj/machinery/status_display{pixel_y = -32},/obj/item/device/radio/intercom{dir = 1; name = "Station Intercom (General)"; pixel_y = 21},/turf/simulated/shuttle/floor,/area/submap/wreckage/escape_pods4)
"q" = (/obj/structure/bed/chair{icon_state = "chair_preview"; dir = 8},/obj/structure/closet/walllocker/emerglocker{pixel_y = 28},/obj/effect/decal/cleanable/dirt,/obj/effect/decal/cleanable/blood/drip,/turf/simulated/shuttle/floor,/area/submap/wreckage/escape_pods4)
"r" = (/obj/structure/bed/chair{icon_state = "chair_preview"; dir = 8},/obj/structure/loot_pile/surface/medicine_cabinet{pixel_y = 28},/obj/machinery/light,/obj/effect/decal/cleanable/vomit,/obj/effect/decal/cleanable/blood/drip,/obj/effect/decal/cleanable/dirt,/obj/effect/decal/cleanable/blood/drip,/obj/item/weapon/reagent_containers/hypospray/autoinjector/empty,/turf/simulated/shuttle/floor,/area/submap/wreckage/escape_pods4)
"s" = (/obj/effect/decal/cleanable/blood/oil,/turf/template_noop,/area/template_noop)
"t" = (/turf/simulated/mineral/floor/ignore_mapgen/vacuum,/area/template_noop)
"u" = (/obj/effect/decal/cleanable/blood/oil,/turf/simulated/mineral/floor/ignore_mapgen/vacuum,/area/template_noop)
"v" = (/obj/effect/decal/cleanable/blood/oil,/obj/effect/decal/cleanable/blood/oil,/turf/simulated/mineral/floor/ignore_mapgen/vacuum,/area/template_noop)

(1,1,1) = {"
tttttasaaaaasaaaaass
tbcbttttttttsaassaaa
tdedttddddftttttasaa
tdgdtthijkctblbtuttt
tdmdttddddftdndtblbt
tdhdttttttttdgdtdndt
ttuttddddfttdmdtdgdt
aaaauopjqlttdhdtdmdt
sasatddddfttttttdhdt
aaaattttttttttattttt
tuttttttddddftsaaaas
tddddfvtoirqltsasaaa
toijqlutddddftaaaasa
uddddfttttttutaasaaa
tttttttaasaasaaaaaaa
"}
