"aa" = (/turf/template_noop,/area/space)
"ab" = (/turf/simulated/mineral/floor/vacuum,/area/space)
"ac" = (/turf/simulated/shuttle/wall/dark,/area/space)
"ad" = (/obj/machinery/door/airlock/external{density = 1; frequency = 1331; id_tag = "merc_shuttle_outer"; name = "Ship External Access"; req_access = list(150)},/turf/simulated/floor/plating,/area/space)
"ae" = (/obj/structure/shuttle/engine/heater{icon_state = "heater"; dir = 4},/turf/simulated/shuttle/wall/dark{icon_state = "dark0"; name = "Unknown Shuttle"},/area/space)
"af" = (/obj/structure/shuttle/engine/propulsion{dir = 4; icon_state = "propulsion_l"},/turf/simulated/floor/plating,/area/space)
"ag" = (/obj/machinery/light{dir = 1},/obj/structure/table/rack,/obj/item/clothing/head/helmet/space,/obj/item/clothing/head/helmet/space,/obj/item/clothing/head/helmet/space,/obj/item/clothing/head/helmet/space,/obj/item/clothing/suit/space,/obj/item/clothing/suit/space,/obj/item/clothing/suit/space,/obj/item/clothing/suit/space,/obj/effect/floor_decal/borderfloor{dir = 9},/turf/simulated/floor/tiled/steel,/area/space)
"ah" = (/obj/structure/dispenser/oxygen,/obj/effect/floor_decal/borderfloor{dir = 5},/turf/simulated/floor/tiled/steel,/area/space)
"ai" = (/turf/simulated/floor/plating,/area/space)
"aj" = (/obj/effect/floor_decal/corner/green/border{icon_state = "bordercolor"; dir = 9},/turf/simulated/floor/tiled/white,/area/space)
"ak" = (/obj/machinery/gibber,/obj/effect/floor_decal/corner/green/border{icon_state = "bordercolor"; dir = 1},/turf/simulated/floor/tiled/white,/area/space)
"al" = (/obj/machinery/light{dir = 1},/obj/effect/floor_decal/corner/green/border{icon_state = "bordercolor"; dir = 1},/turf/simulated/floor/tiled/white,/area/space)
"am" = (/obj/machinery/bodyscanner{dir = 8},/obj/effect/floor_decal/corner/green/border{icon_state = "bordercolor"; dir = 1},/turf/simulated/floor/tiled/white,/area/space)
"an" = (/obj/machinery/body_scanconsole,/obj/effect/floor_decal/corner/green/border{icon_state = "bordercolor"; dir = 5},/turf/simulated/floor/tiled/white,/area/space)
"ao" = (/turf/simulated/shuttle/wall/dark/hard_corner,/area/space)
"ap" = (/turf/simulated/floor/tiled/steel_grid,/area/space)
"aq" = (/obj/structure/table/steel,/obj/item/weapon/gun/projectile/automatic/wt550,/obj/item/weapon/gun/projectile/automatic/p90,/turf/simulated/floor/tiled/steel_grid,/area/space)
"ar" = (/obj/effect/floor_decal/borderfloor{dir = 8},/turf/simulated/floor/tiled/steel,/area/space)
"as" = (/obj/effect/floor_decal/borderfloor{dir = 4},/turf/simulated/floor/tiled/steel,/area/space)
"at" = (/obj/machinery/door/airlock/external,/turf/simulated/floor/plating,/area/space)
"au" = (/obj/effect/floor_decal/corner/green/border{icon_state = "bordercolor"; dir = 8},/turf/simulated/floor/tiled/white,/area/space)
"av" = (/obj/machinery/optable,/turf/simulated/floor/tiled/white,/area/space)
"aw" = (/obj/effect/decal/cleanable/blood,/turf/simulated/floor/tiled/white,/area/space)
"ax" = (/turf/simulated/floor/tiled/white,/area/space)
"ay" = (/mob/living/simple_mob/mechanical/viscerator,/turf/simulated/floor/tiled/white,/area/space)
"az" = (/obj/machinery/organ_printer/flesh,/obj/effect/floor_decal/corner/green/border{icon_state = "bordercolor"; dir = 5},/turf/simulated/floor/tiled/white,/area/space)
"aA" = (/mob/living/simple_mob/mechanical/viscerator,/mob/living/simple_mob/mechanical/viscerator,/mob/living/simple_mob/mechanical/viscerator,/turf/simulated/floor/tiled/steel_grid,/area/space)
"aB" = (/obj/structure/table/steel,/obj/machinery/light/small{dir = 4; pixel_y = 0},/turf/simulated/floor/tiled/steel_grid,/area/space)
"aC" = (/obj/effect/floor_decal/borderfloor/corner{dir = 4},/turf/simulated/floor/tiled/steel,/area/space)
"aD" = (/obj/effect/floor_decal/borderfloor{dir = 1},/turf/simulated/floor/tiled/steel,/area/space)
"aE" = (/obj/effect/floor_decal/borderfloor{dir = 5},/turf/simulated/floor/tiled/steel,/area/space)
"aF" = (/obj/effect/decal/cleanable/blood/drip,/turf/simulated/floor/tiled/white,/area/space)
"aG" = (/obj/structure/loot_pile/surface/bones,/turf/simulated/floor/tiled/white,/area/space)
"aH" = (/obj/machinery/light{dir = 4; icon_state = "tube1"; pixel_x = 0},/obj/effect/floor_decal/corner/green/border{icon_state = "bordercolor"; dir = 4},/turf/simulated/floor/tiled/white,/area/space)
"aI" = (/obj/structure/table/steel,/obj/effect/floor_decal/borderfloor/full,/turf/simulated/floor/tiled/steel,/area/space)
"aJ" = (/obj/structure/table/steel,/obj/item/weapon/grenade/smokebomb,/turf/simulated/floor/tiled/steel_grid,/area/space)
"aK" = (/obj/effect/floor_decal/borderfloor/corner,/turf/simulated/floor/tiled/steel,/area/space)
"aL" = (/obj/effect/floor_decal/borderfloor,/turf/simulated/floor/tiled/steel,/area/space)
"aM" = (/obj/machinery/light{dir = 4; icon_state = "tube1"; pixel_x = 0},/obj/effect/floor_decal/borderfloor{dir = 6},/turf/simulated/floor/tiled/steel,/area/space)
"aN" = (/obj/structure/table/standard,/obj/item/weapon/storage/firstaid/surgery,/obj/effect/floor_decal/corner/green/border{icon_state = "bordercolor"; dir = 10},/turf/simulated/floor/tiled/white,/area/space)
"aO" = (/obj/structure/table/standard,/obj/item/weapon/tank/anesthetic,/obj/effect/floor_decal/corner/green/border,/turf/simulated/floor/tiled/white,/area/space)
"aP" = (/obj/effect/floor_decal/corner/green/border,/turf/simulated/floor/tiled/white,/area/space)
"aQ" = (/obj/structure/table/standard,/obj/item/clothing/gloves/sterile,/obj/item/clothing/gloves/sterile,/obj/effect/floor_decal/corner/green/border,/turf/simulated/floor/tiled/white,/area/space)
"aR" = (/obj/structure/table/standard,/obj/item/weapon/reagent_containers/spray/sterilizine,/obj/item/weapon/reagent_containers/spray/sterilizine,/obj/effect/floor_decal/corner/green/border,/turf/simulated/floor/tiled/white,/area/space)
"aS" = (/obj/structure/table/standard,/obj/item/weapon/storage/box/masks,/obj/effect/floor_decal/corner/green/border{icon_state = "bordercolor"; dir = 6},/turf/simulated/floor/tiled/white,/area/space)
"aT" = (/obj/machinery/light{icon_state = "tube1"; dir = 8},/obj/effect/floor_decal/borderfloor{dir = 9},/turf/simulated/floor/tiled/steel,/area/space)
"aU" = (/obj/structure/bed/chair/office/dark{dir = 1},/obj/effect/floor_decal/borderfloor{dir = 5},/turf/simulated/floor/tiled/steel,/area/space)
"aV" = (/obj/machinery/door/airlock/security{locked = 1},/turf/simulated/floor/tiled/steel,/area/space)
"aW" = (/obj/machinery/door/airlock/glass,/turf/simulated/floor/tiled/white,/area/space)
"aX" = (/obj/machinery/computer/communications,/obj/effect/floor_decal/borderfloor{dir = 9},/turf/simulated/floor/tiled/steel,/area/space)
"aY" = (/obj/effect/floor_decal/borderfloor/corner{dir = 1},/turf/simulated/floor/tiled/steel,/area/space)
"aZ" = (/obj/effect/floor_decal/borderfloor{dir = 9},/turf/simulated/floor/tiled/steel,/area/space)
"ba" = (/obj/structure/closet/secure_closet/freezer/fridge,/turf/simulated/floor/tiled/steel,/area/space)
"bb" = (/obj/structure/table/steel,/obj/item/weapon/material/knife,/turf/simulated/floor/tiled/steel,/area/space)
"bc" = (/turf/simulated/floor/tiled/steel,/area/space)
"bd" = (/obj/machinery/light{dir = 1},/turf/simulated/floor/tiled/steel,/area/space)
"be" = (/obj/structure/table/steel,/obj/random/toolbox,/turf/simulated/floor/tiled/yellow,/area/space)
"bf" = (/obj/structure/table/steel,/obj/machinery/light/small{dir = 4; pixel_y = 0},/obj/random/projectile/scrapped_gun,/obj/random/projectile/scrapped_gun,/turf/simulated/floor/tiled/yellow,/area/space)
"bg" = (/obj/structure/grille,/obj/structure/window/reinforced{dir = 1},/obj/structure/window/reinforced{dir = 8},/obj/structure/window/reinforced{dir = 4},/turf/simulated/floor/plating,/area/space)
"bh" = (/obj/structure/table/steel,/obj/effect/floor_decal/borderfloor{dir = 8},/turf/simulated/floor/tiled/steel,/area/space)
"bi" = (/obj/machinery/light{icon_state = "tube1"; dir = 8},/obj/effect/floor_decal/borderfloor{dir = 8},/turf/simulated/floor/tiled/steel,/area/space)
"bj" = (/obj/machinery/light{dir = 4; icon_state = "tube1"; pixel_x = 0},/obj/effect/floor_decal/borderfloor{dir = 4},/turf/simulated/floor/tiled/steel,/area/space)
"bk" = (/obj/item/weapon/stool,/turf/simulated/floor/tiled/steel,/area/space)
"bl" = (/obj/structure/table/steel,/obj/random/projectile,/turf/simulated/floor/tiled/yellow,/area/space)
"bm" = (/obj/machinery/fusion_fuel_compressor,/turf/simulated/floor/tiled/yellow,/area/space)
"bn" = (/obj/structure/shuttle/engine/heater{icon_state = "heater"; dir = 4},/turf/simulated/shuttle/wall/dark,/area/space)
"bo" = (/obj/structure/grille,/obj/structure/window/reinforced{dir = 4},/obj/structure/window/reinforced{dir = 8},/turf/simulated/floor/plating,/area/space)
"bp" = (/obj/machinery/door/airlock/glass,/obj/effect/floor_decal/borderfloor{dir = 1},/turf/simulated/floor/tiled/steel,/area/space)
"bq" = (/obj/effect/floor_decal/corner/grey,/mob/living/simple_mob/mechanical/viscerator,/turf/simulated/floor/tiled/steel,/area/space)
"br" = (/obj/machinery/door/airlock/glass,/turf/simulated/floor/tiled/steel,/area/space)
"bs" = (/mob/living/simple_mob/mechanical/viscerator,/turf/simulated/floor/tiled/steel,/area/space)
"bt" = (/obj/structure/table/steel,/obj/item/pizzabox,/turf/simulated/floor/tiled/steel,/area/space)
"bu" = (/obj/structure/table/steel,/turf/simulated/floor/tiled/steel,/area/space)
"bv" = (/obj/machinery/door/airlock,/turf/simulated/floor/tiled/steel,/area/space)
"bw" = (/obj/structure/loot_pile/surface/bones,/turf/simulated/floor/tiled/steel,/area/space)
"bx" = (/obj/machinery/fusion_fuel_injector/mapped{icon_state = "injector0"; dir = 4},/turf/simulated/floor/tiled/yellow,/area/space)
"by" = (/obj/machinery/door/airlock/glass,/obj/effect/floor_decal/borderfloor,/turf/simulated/floor/tiled/steel,/area/space)
"bz" = (/obj/effect/floor_decal/borderfloor/corner{dir = 8},/turf/simulated/floor/tiled/steel,/area/space)
"bA" = (/obj/structure/grille,/obj/structure/window/reinforced,/obj/structure/window/reinforced{dir = 8},/obj/structure/window/reinforced{dir = 4},/turf/simulated/floor/plating,/area/space)
"bB" = (/obj/machinery/power/apc{dir = 8; name = "BSD APC"; pixel_x = -24},/turf/simulated/floor/tiled/yellow,/area/space)
"bC" = (/turf/simulated/floor/tiled/yellow,/area/space)
"bD" = (/obj/machinery/computer/area_atmos,/obj/effect/floor_decal/borderfloor{dir = 10},/turf/simulated/floor/tiled/steel,/area/space)
"bE" = (/obj/effect/floor_decal/borderfloor{dir = 10},/turf/simulated/floor/tiled/steel,/area/space)
"bF" = (/obj/effect/floor_decal/borderfloor{dir = 4},/obj/effect/floor_decal/borderfloor{dir = 4},/turf/simulated/floor/tiled/steel,/area/space)
"bG" = (/obj/structure/table/steel,/obj/item/weapon/paper_bin,/turf/simulated/floor/tiled/steel,/area/space)
"bH" = (/obj/machinery/light,/turf/simulated/floor/tiled/steel,/area/space)
"bI" = (/obj/structure/closet/toolcloset,/turf/simulated/floor/tiled/yellow,/area/space)
"bJ" = (/obj/machinery/portable_atmospherics/canister/empty/oxygen,/turf/simulated/floor/tiled/yellow,/area/space)
"bK" = (/obj/machinery/atmospherics/pipe/tank/oxygen,/obj/machinery/light/small{dir = 4; pixel_y = 0},/turf/simulated/floor/tiled/yellow,/area/space)
"bL" = (/obj/machinery/light{icon_state = "tube1"; dir = 8},/obj/effect/floor_decal/borderfloor{dir = 10},/turf/simulated/floor/tiled/steel,/area/space)
"bM" = (/obj/structure/bed/chair/office/dark,/obj/effect/floor_decal/borderfloor{dir = 6},/turf/simulated/floor/tiled/steel,/area/space)
"bN" = (/obj/structure/table/steel,/turf/simulated/floor/tiled/steel_grid,/area/space)
"bO" = (/obj/effect/floor_decal/borderfloor/corner{dir = 4},/obj/effect/floor_decal/borderfloor/corner{dir = 4},/turf/simulated/floor/tiled/steel,/area/space)
"bP" = (/obj/machinery/light{dir = 4; icon_state = "tube1"; pixel_x = 0},/obj/effect/floor_decal/borderfloor{dir = 5},/turf/simulated/floor/tiled/steel,/area/space)
"bQ" = (/obj/structure/bed,/obj/item/weapon/bedsheet,/turf/simulated/floor/tiled/steel,/area/space)
"bR" = (/obj/machinery/door/airlock,/turf/simulated/floor/tiled/hydro,/area/space)
"bS" = (/turf/simulated/floor/tiled/hydro,/area/space)
"bT" = (/mob/living/simple_mob/mechanical/viscerator,/turf/simulated/floor/tiled/steel_grid,/area/space)
"bU" = (/obj/structure/table/steel,/obj/item/weapon/gun/projectile/pistol,/obj/machinery/light/small{dir = 4; pixel_y = 0},/turf/simulated/floor/tiled/steel_grid,/area/space)
"bV" = (/obj/effect/floor_decal/borderfloor{dir = 6},/turf/simulated/floor/tiled/steel,/area/space)
"bW" = (/obj/structure/bed,/obj/item/weapon/bedsheet,/obj/structure/bed,/turf/simulated/floor/tiled/steel,/area/space)
"bX" = (/obj/machinery/light/small{dir = 4; pixel_y = 0},/turf/simulated/floor/tiled/hydro,/area/space)
"bY" = (/mob/living/simple_mob/mechanical/viscerator,/mob/living/simple_mob/mechanical/viscerator,/turf/simulated/floor/tiled/steel_grid,/area/space)
"bZ" = (/obj/structure/toilet{dir = 1},/turf/simulated/floor/tiled/hydro,/area/space)
"ca" = (/obj/machinery/light,/obj/structure/table/rack,/obj/item/clothing/head/helmet/space,/obj/item/clothing/head/helmet/space,/obj/item/clothing/head/helmet/space,/obj/item/clothing/head/helmet/space,/obj/item/clothing/suit/space,/obj/item/clothing/suit/space,/obj/item/clothing/suit/space,/obj/item/clothing/suit/space,/obj/effect/floor_decal/borderfloor{dir = 10},/turf/simulated/floor/tiled/steel,/area/space)
"cb" = (/obj/structure/dispenser/oxygen,/obj/effect/floor_decal/borderfloor{dir = 6},/turf/simulated/floor/tiled/steel,/area/space)
"cc" = (/obj/structure/table/woodentable,/obj/random/projectile,/turf/simulated/floor/tiled/steel,/area/space)
"cd" = (/obj/structure/bed,/obj/item/weapon/bedsheet,/obj/machinery/light,/turf/simulated/floor/tiled/steel,/area/space)
"ce" = (/obj/structure/table/woodentable,/turf/simulated/floor/tiled/steel,/area/space)

(1,1,1) = {"
aaaaabababababababaaaaaaaaaaaaaaaaaaaaabababababababaa
aaaaabacacacacacabababababababababababacacacacacacabaa
aaaaabacacacacacacacacaoadadaoacacacacacacacacaeafabaa
aaaaabacacacacacacagahacaiaiacajakalamanaoacacaeafabaa
aaaaababacacapaqacarasaoatataoauavawaxayaxazacacacabaa
aaababacacacaAaBacaraCaDaDaEacauaFaFaGaxawaHacacababaa
ababacaoaIacapaJacaraKaLaLaMacaNaOaxaPaQaRaSacabababaa
abacaoaTaUacaVacaoarasaoacacacacacaWacacacacacacacabab
abacaXaYasacaZaDaDaYasacbabbbcbdbcbcbcacbebebfaoacacab
abbgbhbcasaobibcbcbcbjaobcbcbkbkbkbcbcacblbcbcbmbnafab
abbobhbcaCbpaYbcbqbcbcbrbcbsbtbububcbcbvbcbsbwbxbnafab
abbobhbcaKbybzbsbcbcbcbrbcbcbubububcbcbvbcbsbcbxbnafab
abbAbhbcasaobibcbcbwbjaobcbcbkbkbkbwbcacbBbcbcbCbnafab
abacbDbzasacbEaLaLbzbFacbubGbcbHbcbcbcacbIbJbKaoacacab
abacaobLbMacaVacaoarasaoacacacacacbracacacacacacacabab
ababacaoaIacapbNacarbOaDaDbPacbQbcbcbsbcbRbSacabababaa
aaababacacacbTbUacaraKaLaLbVacbWbcbQbcbQacbXacacababaa
aaaaababacacbYbNacarasaoatataobQbcbQbcbQacbZacacacabaa
aaaaabacacacacacaccacbacaiaiacbQcccdcebQacacacaeafabaa
aaaaabacacacacacacacacaoadadaoacacacacacacacacaeafabaa
aaaaabacacacacacabababababababababababacacacacacacabaa
aaaaabababababababaaaaaaaaaaaaaaaaaaababababababababaa
"}
