"aa" = (/turf/template_noop,/area/template_noop)
"ab" = (/turf/simulated/mineral/floor/vacuum,/area/template_noop)
"ac" = (/turf/simulated/shuttle/wall/dark/hard_corner,/area/submap/shuttles/mercenary1)
"ad" = (/turf/simulated/shuttle/wall/dark,/area/submap/shuttles/mercenary1)
"ae" = (/obj/machinery/door/airlock/external{density = 1; frequency = 1331; id_tag = "merc_shuttle_outer"; name = "Ship External Access"; req_access = list(150)},/turf/simulated/floor/plating,/area/submap/shuttles/mercenary1)
"af" = (/obj/structure/shuttle/engine/heater{icon_state = "heater"; dir = 4},/turf/simulated/shuttle/wall/dark{icon_state = "dark0"; name = "Unknown Shuttle"},/area/submap/shuttles/mercenary1)
"ag" = (/obj/structure/shuttle/engine/propulsion{dir = 4; icon_state = "propulsion_l"},/turf/simulated/floor/plating,/area/submap/shuttles/mercenary1)
"ai" = (/obj/machinery/light{dir = 1},/obj/structure/table/rack,/obj/item/clothing/head/helmet/space,/obj/item/clothing/head/helmet/space,/obj/item/clothing/head/helmet/space,/obj/item/clothing/head/helmet/space,/obj/item/clothing/suit/space,/obj/item/clothing/suit/space,/obj/item/clothing/suit/space,/obj/item/clothing/suit/space,/obj/effect/floor_decal/borderfloor{dir = 9},/turf/simulated/floor/tiled/steel,/area/submap/shuttles/mercenary1)
"aj" = (/obj/structure/dispenser/oxygen,/obj/effect/floor_decal/borderfloor{dir = 5},/turf/simulated/floor/tiled/steel,/area/submap/shuttles/mercenary1)
"ak" = (/turf/simulated/floor/plating,/area/submap/shuttles/mercenary1)
"al" = (/obj/effect/floor_decal/corner/green/border{icon_state = "bordercolor"; dir = 9},/turf/simulated/floor/tiled/white,/area/submap/shuttles/mercenary1)
"am" = (/obj/machinery/gibber,/obj/effect/floor_decal/corner/green/border{icon_state = "bordercolor"; dir = 1},/turf/simulated/floor/tiled/white,/area/submap/shuttles/mercenary1)
"an" = (/obj/machinery/light{dir = 1},/obj/effect/floor_decal/corner/green/border{icon_state = "bordercolor"; dir = 1},/turf/simulated/floor/tiled/white,/area/submap/shuttles/mercenary1)
"ao" = (/obj/machinery/bodyscanner{dir = 8},/obj/effect/floor_decal/corner/green/border{icon_state = "bordercolor"; dir = 1},/turf/simulated/floor/tiled/white,/area/submap/shuttles/mercenary1)
"ap" = (/obj/machinery/body_scanconsole,/obj/effect/floor_decal/corner/green/border{icon_state = "bordercolor"; dir = 5},/turf/simulated/floor/tiled/white,/area/submap/shuttles/mercenary1)
"aq" = (/turf/simulated/floor/tiled/steel_grid,/area/submap/shuttles/mercenary1)
"ar" = (/obj/structure/table/steel,/obj/item/weapon/gun/projectile/automatic/wt550,/obj/item/weapon/gun/projectile/automatic/p90,/turf/simulated/floor/tiled/steel_grid,/area/submap/shuttles/mercenary1)
"as" = (/obj/effect/floor_decal/borderfloor{dir = 8},/turf/simulated/floor/tiled/steel,/area/submap/shuttles/mercenary1)
"at" = (/obj/effect/floor_decal/borderfloor{dir = 4},/turf/simulated/floor/tiled/steel,/area/submap/shuttles/mercenary1)
"au" = (/obj/machinery/door/airlock/external,/turf/simulated/floor/plating,/area/submap/shuttles/mercenary1)
"av" = (/obj/effect/floor_decal/corner/green/border{icon_state = "bordercolor"; dir = 8},/turf/simulated/floor/tiled/white,/area/submap/shuttles/mercenary1)
"aw" = (/obj/machinery/optable,/turf/simulated/floor/tiled/white,/area/submap/shuttles/mercenary1)
"ax" = (/obj/effect/decal/cleanable/blood,/turf/simulated/floor/tiled/white,/area/submap/shuttles/mercenary1)
"ay" = (/turf/simulated/floor/tiled/white,/area/submap/shuttles/mercenary1)
"az" = (/mob/living/simple_mob/mechanical/viscerator,/turf/simulated/floor/tiled/white,/area/submap/shuttles/mercenary1)
"aA" = (/obj/machinery/organ_printer/flesh,/obj/effect/floor_decal/corner/green/border{icon_state = "bordercolor"; dir = 5},/turf/simulated/floor/tiled/white,/area/submap/shuttles/mercenary1)
"aB" = (/mob/living/simple_mob/mechanical/viscerator,/mob/living/simple_mob/mechanical/viscerator,/mob/living/simple_mob/mechanical/viscerator,/turf/simulated/floor/tiled/steel_grid,/area/submap/shuttles/mercenary1)
"aC" = (/obj/structure/table/steel,/obj/machinery/light/small{dir = 4; pixel_y = 0},/turf/simulated/floor/tiled/steel_grid,/area/submap/shuttles/mercenary1)
"aD" = (/obj/effect/floor_decal/borderfloor/corner{dir = 4},/turf/simulated/floor/tiled/steel,/area/submap/shuttles/mercenary1)
"aE" = (/obj/effect/floor_decal/borderfloor{dir = 1},/turf/simulated/floor/tiled/steel,/area/submap/shuttles/mercenary1)
"aF" = (/obj/effect/floor_decal/borderfloor{dir = 5},/turf/simulated/floor/tiled/steel,/area/submap/shuttles/mercenary1)
"aG" = (/obj/effect/decal/cleanable/blood/drip,/turf/simulated/floor/tiled/white,/area/submap/shuttles/mercenary1)
"aH" = (/obj/structure/loot_pile/surface/bones,/turf/simulated/floor/tiled/white,/area/submap/shuttles/mercenary1)
"aI" = (/obj/machinery/light{dir = 4; icon_state = "tube1"; pixel_x = 0},/obj/effect/floor_decal/corner/green/border{icon_state = "bordercolor"; dir = 4},/turf/simulated/floor/tiled/white,/area/submap/shuttles/mercenary1)
"aJ" = (/obj/structure/table/steel,/obj/effect/floor_decal/borderfloor/full,/turf/simulated/floor/tiled/steel,/area/submap/shuttles/mercenary1)
"aK" = (/obj/structure/table/steel,/obj/item/weapon/grenade/smokebomb,/turf/simulated/floor/tiled/steel_grid,/area/submap/shuttles/mercenary1)
"aL" = (/obj/effect/floor_decal/borderfloor/corner,/turf/simulated/floor/tiled/steel,/area/submap/shuttles/mercenary1)
"aM" = (/obj/effect/floor_decal/borderfloor,/turf/simulated/floor/tiled/steel,/area/submap/shuttles/mercenary1)
"aN" = (/obj/machinery/light{dir = 4; icon_state = "tube1"; pixel_x = 0},/obj/effect/floor_decal/borderfloor{dir = 6},/turf/simulated/floor/tiled/steel,/area/submap/shuttles/mercenary1)
"aO" = (/obj/structure/table/standard,/obj/item/weapon/storage/firstaid/surgery,/obj/effect/floor_decal/corner/green/border{icon_state = "bordercolor"; dir = 10},/turf/simulated/floor/tiled/white,/area/submap/shuttles/mercenary1)
"aP" = (/obj/structure/table/standard,/obj/item/weapon/tank/anesthetic,/obj/effect/floor_decal/corner/green/border,/turf/simulated/floor/tiled/white,/area/submap/shuttles/mercenary1)
"aQ" = (/obj/effect/floor_decal/corner/green/border,/turf/simulated/floor/tiled/white,/area/submap/shuttles/mercenary1)
"aR" = (/obj/structure/table/standard,/obj/item/clothing/gloves/sterile,/obj/item/clothing/gloves/sterile,/obj/effect/floor_decal/corner/green/border,/turf/simulated/floor/tiled/white,/area/submap/shuttles/mercenary1)
"aS" = (/obj/structure/table/standard,/obj/item/weapon/reagent_containers/spray/sterilizine,/obj/item/weapon/reagent_containers/spray/sterilizine,/obj/effect/floor_decal/corner/green/border,/turf/simulated/floor/tiled/white,/area/submap/shuttles/mercenary1)
"aT" = (/obj/structure/table/standard,/obj/item/weapon/storage/box/masks,/obj/effect/floor_decal/corner/green/border{icon_state = "bordercolor"; dir = 6},/turf/simulated/floor/tiled/white,/area/submap/shuttles/mercenary1)
"aU" = (/obj/machinery/light{icon_state = "tube1"; dir = 8},/obj/effect/floor_decal/borderfloor{dir = 9},/turf/simulated/floor/tiled/steel,/area/submap/shuttles/mercenary1)
"aV" = (/obj/structure/bed/chair/office/dark{dir = 1},/obj/effect/floor_decal/borderfloor{dir = 5},/turf/simulated/floor/tiled/steel,/area/submap/shuttles/mercenary1)
"aW" = (/obj/machinery/door/airlock/security{locked = 1},/turf/simulated/floor/tiled/steel,/area/submap/shuttles/mercenary1)
"aX" = (/obj/machinery/door/airlock/glass,/turf/simulated/floor/tiled/white,/area/submap/shuttles/mercenary1)
"aY" = (/obj/machinery/computer/communications,/obj/effect/floor_decal/borderfloor{dir = 9},/turf/simulated/floor/tiled/steel,/area/submap/shuttles/mercenary1)
"aZ" = (/obj/effect/floor_decal/borderfloor/corner{dir = 1},/turf/simulated/floor/tiled/steel,/area/submap/shuttles/mercenary1)
"ba" = (/obj/effect/floor_decal/borderfloor{dir = 9},/turf/simulated/floor/tiled/steel,/area/submap/shuttles/mercenary1)
"bb" = (/obj/structure/closet/secure_closet/freezer/fridge,/turf/simulated/floor/tiled/steel,/area/submap/shuttles/mercenary1)
"bc" = (/obj/structure/table/steel,/obj/item/weapon/material/knife,/turf/simulated/floor/tiled/steel,/area/submap/shuttles/mercenary1)
"bd" = (/turf/simulated/floor/tiled/steel,/area/submap/shuttles/mercenary1)
"be" = (/obj/machinery/light{dir = 1},/turf/simulated/floor/tiled/steel,/area/submap/shuttles/mercenary1)
"bf" = (/obj/structure/table/steel,/obj/random/toolbox,/turf/simulated/floor/tiled/yellow,/area/submap/shuttles/mercenary1)
"bg" = (/obj/structure/table/steel,/obj/machinery/light/small{dir = 4; pixel_y = 0},/obj/random/projectile/scrapped_gun,/obj/random/projectile/scrapped_gun,/turf/simulated/floor/tiled/yellow,/area/submap/shuttles/mercenary1)
"bh" = (/obj/structure/grille,/obj/structure/window/reinforced{dir = 1},/obj/structure/window/reinforced{dir = 8},/obj/structure/window/reinforced{dir = 4},/turf/simulated/floor/plating,/area/submap/shuttles/mercenary1)
"bi" = (/obj/structure/table/steel,/obj/effect/floor_decal/borderfloor{dir = 8},/turf/simulated/floor/tiled/steel,/area/submap/shuttles/mercenary1)
"bj" = (/obj/machinery/light{icon_state = "tube1"; dir = 8},/obj/effect/floor_decal/borderfloor{dir = 8},/turf/simulated/floor/tiled/steel,/area/submap/shuttles/mercenary1)
"bk" = (/obj/machinery/light{dir = 4; icon_state = "tube1"; pixel_x = 0},/obj/effect/floor_decal/borderfloor{dir = 4},/turf/simulated/floor/tiled/steel,/area/submap/shuttles/mercenary1)
"bl" = (/obj/item/weapon/stool,/turf/simulated/floor/tiled/steel,/area/submap/shuttles/mercenary1)
"bm" = (/obj/structure/table/steel,/obj/random/projectile,/turf/simulated/floor/tiled/yellow,/area/submap/shuttles/mercenary1)
"bn" = (/obj/machinery/fusion_fuel_compressor,/turf/simulated/floor/tiled/yellow,/area/submap/shuttles/mercenary1)
"bo" = (/obj/structure/shuttle/engine/heater{icon_state = "heater"; dir = 4},/turf/simulated/shuttle/wall/dark,/area/submap/shuttles/mercenary1)
"bp" = (/obj/structure/grille,/obj/structure/window/reinforced{dir = 4},/obj/structure/window/reinforced{dir = 8},/turf/simulated/floor/plating,/area/submap/shuttles/mercenary1)
"bq" = (/obj/machinery/door/airlock/glass,/obj/effect/floor_decal/borderfloor{dir = 1},/turf/simulated/floor/tiled/steel,/area/submap/shuttles/mercenary1)
"br" = (/obj/effect/floor_decal/corner/grey,/mob/living/simple_mob/mechanical/viscerator,/turf/simulated/floor/tiled/steel,/area/submap/shuttles/mercenary1)
"bs" = (/obj/machinery/door/airlock/glass,/turf/simulated/floor/tiled/steel,/area/submap/shuttles/mercenary1)
"bt" = (/mob/living/simple_mob/mechanical/viscerator,/turf/simulated/floor/tiled/steel,/area/submap/shuttles/mercenary1)
"bu" = (/obj/structure/table/steel,/obj/item/pizzabox,/turf/simulated/floor/tiled/steel,/area/submap/shuttles/mercenary1)
"bv" = (/obj/structure/table/steel,/turf/simulated/floor/tiled/steel,/area/submap/shuttles/mercenary1)
"bw" = (/obj/machinery/door/airlock,/turf/simulated/floor/tiled/steel,/area/submap/shuttles/mercenary1)
"bx" = (/obj/structure/loot_pile/surface/bones,/turf/simulated/floor/tiled/steel,/area/submap/shuttles/mercenary1)
"by" = (/obj/machinery/fusion_fuel_injector/mapped{icon_state = "injector0"; dir = 4},/turf/simulated/floor/tiled/yellow,/area/submap/shuttles/mercenary1)
"bz" = (/obj/machinery/door/airlock/glass,/obj/effect/floor_decal/borderfloor,/turf/simulated/floor/tiled/steel,/area/submap/shuttles/mercenary1)
"bA" = (/obj/effect/floor_decal/borderfloor/corner{dir = 8},/turf/simulated/floor/tiled/steel,/area/submap/shuttles/mercenary1)
"bB" = (/obj/structure/grille,/obj/structure/window/reinforced,/obj/structure/window/reinforced{dir = 8},/obj/structure/window/reinforced{dir = 4},/turf/simulated/floor/plating,/area/submap/shuttles/mercenary1)
"bC" = (/obj/machinery/power/apc{dir = 8; name = "BSD APC"; pixel_x = -24},/turf/simulated/floor/tiled/yellow,/area/submap/shuttles/mercenary1)
"bD" = (/turf/simulated/floor/tiled/yellow,/area/submap/shuttles/mercenary1)
"bE" = (/obj/machinery/computer/area_atmos,/obj/effect/floor_decal/borderfloor{dir = 10},/turf/simulated/floor/tiled/steel,/area/submap/shuttles/mercenary1)
"bF" = (/obj/effect/floor_decal/borderfloor{dir = 10},/turf/simulated/floor/tiled/steel,/area/submap/shuttles/mercenary1)
"bG" = (/obj/effect/floor_decal/borderfloor{dir = 4},/obj/effect/floor_decal/borderfloor{dir = 4},/turf/simulated/floor/tiled/steel,/area/submap/shuttles/mercenary1)
"bH" = (/obj/structure/table/steel,/obj/item/weapon/paper_bin,/turf/simulated/floor/tiled/steel,/area/submap/shuttles/mercenary1)
"bI" = (/obj/machinery/light,/turf/simulated/floor/tiled/steel,/area/submap/shuttles/mercenary1)
"bJ" = (/obj/structure/closet/toolcloset,/turf/simulated/floor/tiled/yellow,/area/submap/shuttles/mercenary1)
"bK" = (/obj/machinery/portable_atmospherics/canister/empty/oxygen,/turf/simulated/floor/tiled/yellow,/area/submap/shuttles/mercenary1)
"bL" = (/obj/machinery/atmospherics/pipe/tank/oxygen,/obj/machinery/light/small{dir = 4; pixel_y = 0},/turf/simulated/floor/tiled/yellow,/area/submap/shuttles/mercenary1)
"bM" = (/obj/machinery/light{icon_state = "tube1"; dir = 8},/obj/effect/floor_decal/borderfloor{dir = 10},/turf/simulated/floor/tiled/steel,/area/submap/shuttles/mercenary1)
"bN" = (/obj/structure/bed/chair/office/dark,/obj/effect/floor_decal/borderfloor{dir = 6},/turf/simulated/floor/tiled/steel,/area/submap/shuttles/mercenary1)
"bO" = (/obj/structure/table/steel,/turf/simulated/floor/tiled/steel_grid,/area/submap/shuttles/mercenary1)
"bP" = (/obj/effect/floor_decal/borderfloor/corner{dir = 4},/obj/effect/floor_decal/borderfloor/corner{dir = 4},/turf/simulated/floor/tiled/steel,/area/submap/shuttles/mercenary1)
"bQ" = (/obj/machinery/light{dir = 4; icon_state = "tube1"; pixel_x = 0},/obj/effect/floor_decal/borderfloor{dir = 5},/turf/simulated/floor/tiled/steel,/area/submap/shuttles/mercenary1)
"bR" = (/obj/structure/bed,/obj/item/weapon/bedsheet,/turf/simulated/floor/tiled/steel,/area/submap/shuttles/mercenary1)
"bS" = (/obj/machinery/door/airlock,/turf/simulated/floor/tiled/hydro,/area/submap/shuttles/mercenary1)
"bT" = (/turf/simulated/floor/tiled/hydro,/area/submap/shuttles/mercenary1)
"bU" = (/mob/living/simple_mob/mechanical/viscerator,/turf/simulated/floor/tiled/steel_grid,/area/submap/shuttles/mercenary1)
"bV" = (/obj/structure/table/steel,/obj/item/weapon/gun/projectile/pistol,/obj/machinery/light/small{dir = 4; pixel_y = 0},/turf/simulated/floor/tiled/steel_grid,/area/submap/shuttles/mercenary1)
"bW" = (/obj/effect/floor_decal/borderfloor{dir = 6},/turf/simulated/floor/tiled/steel,/area/submap/shuttles/mercenary1)
"bX" = (/obj/structure/bed,/obj/item/weapon/bedsheet,/obj/structure/bed,/turf/simulated/floor/tiled/steel,/area/submap/shuttles/mercenary1)
"bY" = (/obj/machinery/light/small{dir = 4; pixel_y = 0},/turf/simulated/floor/tiled/hydro,/area/submap/shuttles/mercenary1)
"bZ" = (/mob/living/simple_mob/mechanical/viscerator,/mob/living/simple_mob/mechanical/viscerator,/turf/simulated/floor/tiled/steel_grid,/area/submap/shuttles/mercenary1)
"ca" = (/obj/structure/toilet{dir = 1},/turf/simulated/floor/tiled/hydro,/area/submap/shuttles/mercenary1)
"cb" = (/obj/machinery/light,/obj/structure/table/rack,/obj/item/clothing/head/helmet/space,/obj/item/clothing/head/helmet/space,/obj/item/clothing/head/helmet/space,/obj/item/clothing/head/helmet/space,/obj/item/clothing/suit/space,/obj/item/clothing/suit/space,/obj/item/clothing/suit/space,/obj/item/clothing/suit/space,/obj/effect/floor_decal/borderfloor{dir = 10},/turf/simulated/floor/tiled/steel,/area/submap/shuttles/mercenary1)
"cc" = (/obj/structure/dispenser/oxygen,/obj/effect/floor_decal/borderfloor{dir = 6},/turf/simulated/floor/tiled/steel,/area/submap/shuttles/mercenary1)
"cd" = (/obj/structure/table/woodentable,/obj/random/projectile,/turf/simulated/floor/tiled/steel,/area/submap/shuttles/mercenary1)
"ce" = (/obj/structure/bed,/obj/item/weapon/bedsheet,/obj/machinery/light,/turf/simulated/floor/tiled/steel,/area/submap/shuttles/mercenary1)
"cf" = (/obj/structure/table/woodentable,/turf/simulated/floor/tiled/steel,/area/submap/shuttles/mercenary1)

(1,1,1) = {"
aaaaabababababababaaaaaaaaaaaaaaaaaaaaabababababababaa
aaaaabadadadadadabababababababababababadadadadadadabaa
aaaaabadadadadadadadadacaeaeacadadadadadadadadafagabaa
aaaaabadadadadadadaiajadakakadalamanaoapacadadafagabaa
aaaaababadadaqaradasatacauauacavawaxayazayaAadadadabaa
aaababadadadaBaCadasaDaEaEaFadavaGaGaHayaxaIadadababaa
ababadacaJadaqaKadasaLaMaMaNadaOaPayaQaRaSaTadabababaa
abadacaUaVadaWadacasatacadadadadadaXadadadadadadadabab
abadaYaZatadbaaEaEaZatadbbbcbdbebdbdbdadbfbfbgacadadab
abbhbibdatacbjbdbdbdbkacbdbdblblblbdbdadbmbdbdbnboagab
abbpbibdaDbqaZbdbrbdbdbsbdbtbubvbvbdbdbwbdbtbxbyboagab
abbpbibdaLbzbAbtbdbdbdbsbdbdbvbvbvbdbdbwbdbtbdbyboagab
abbBbibdatacbjbdbdbxbkacbdbdblblblbxbdadbCbdbdbDboagab
abadbEbAatadbFaMaMbAbGadbvbHbdbIbdbdbdadbJbKbLacadadab
abadacbMbNadaWadacasatacadadadadadbsadadadadadadadabab
ababadacaJadaqbOadasbPaEaEbQadbRbdbdbtbdbSbTadabababaa
aaababadadadbUbVadasaLaMaMbWadbXbdbRbdbRadbYadadababaa
aaaaababadadbZbOadasatacauauacbRbdbRbdbRadcaadadadabaa
aaaaabadadadadadadcbccadakakadbRcdcecfbRadadadafagabaa
aaaaabadadadadadadadadacaeaeacadadadadadadadadafagabaa
aaaaabadadadadadabababababababababababadadadadadadabaa
aaaaabababababababaaaaaaaaaaaaaaaaaaababababababababaa
"}
