"a" = (/turf/template_noop,/area/template_noop)
"b" = (/turf/simulated/wall/r_wall,/area/submap/hidden_stash1)
"c" = (/obj/structure/table/steel,/obj/random/maintenance/engineering,/obj/random/maintenance/engineering,/obj/item/stack/rods,/obj/random/tool,/turf/simulated/floor/airless,/area/submap/hidden_stash1)
"d" = (/obj/structure/table/steel,/obj/random/maintenance/security,/obj/item/stack/cable_coil/random,/obj/random/tool,/turf/simulated/floor/airless,/area/submap/hidden_stash1)
"e" = (/obj/structure/table/steel,/obj/random/maintenance/engineering,/turf/simulated/floor/airless,/area/submap/hidden_stash1)
"f" = (/obj/structure/table/steel,/obj/random/maintenance/engineering,/obj/random/maintenance/engineering,/turf/simulated/floor/airless,/area/submap/hidden_stash1)
"g" = (/obj/structure/table/steel,/obj/item/weapon/storage/box/glasses,/turf/simulated/floor/airless,/area/submap/hidden_stash1)
"h" = (/obj/structure/table/steel,/obj/random/toolbox,/obj/random/tool,/turf/simulated/floor/airless,/area/submap/hidden_stash1)
"i" = (/turf/simulated/floor/airless,/area/submap/hidden_stash1)
"j" = (/obj/structure/table/steel,/obj/item/weapon/tape_roll,/obj/random/maintenance/engineering,/turf/simulated/floor/airless,/area/submap/hidden_stash1)
"k" = (/obj/structure/table/steel,/obj/random/maintenance/engineering,/obj/random/maintenance/engineering,/obj/item/stack/tile/floor/steel,/turf/simulated/floor/airless,/area/submap/hidden_stash1)
"l" = (/obj/structure/inflatable/door,/turf/simulated/floor/airless,/area/submap/hidden_stash1)
"m" = (/obj/structure/closet/wardrobe/grey,/obj/random/multiple/voidsuit,/turf/simulated/floor/airless,/area/submap/hidden_stash1)
"n" = (/obj/structure/closet/crate/freezer/rations,/turf/simulated/floor/airless,/area/submap/hidden_stash1)
"o" = (/obj/structure/reagent_dispensers/water_cooler/full,/turf/simulated/floor/airless,/area/submap/hidden_stash1)
"p" = (/obj/structure/table/rack,/obj/random/projectile/random,/turf/simulated/floor/airless,/area/submap/hidden_stash1)
"q" = (/obj/structure/loot_pile/maint/technical,/turf/simulated/floor/airless,/area/submap/hidden_stash1)
"r" = (/obj/structure/table/rack,/obj/item/weapon/tank/emergency/oxygen/engi,/obj/item/weapon/tank/emergency/oxygen/engi,/obj/item/clothing/mask/gas,/obj/item/clothing/suit/armor/material/makeshift,/obj/item/clothing/head/helmet/bucket,/turf/simulated/floor/airless,/area/submap/hidden_stash1)
"s" = (/obj/structure/table/rack,/obj/random/maintenance/engineering,/obj/random/maintenance/engineering,/obj/random/maintenance/security,/obj/random/maintenance/security,/obj/random/maintenance/security,/turf/simulated/floor/airless,/area/submap/hidden_stash1)
"t" = (/obj/item/device/flashlight/lantern,/obj/structure/table/rack,/turf/simulated/floor/airless,/area/submap/hidden_stash1)
"u" = (/obj/structure/table/rack,/obj/item/weapon/gun/projectile/shotgun/pump/rifle/lever,/obj/item/ammo_magazine/clip/c762,/obj/item/ammo_magazine/clip/c762,/turf/simulated/floor/airless,/area/submap/hidden_stash1)

(1,1,1) = {"
aaaaaaaaaa
aabbbbbbaa
abbcdefbba
abghiijkba
aliiiiimba
aliiiiinba
abopiiqnba
abbrstubba
aabbbbbbaa
aaaaaaaaaa
"}
