"aa" = (/turf/template_noop,/area/template_noop)
"ab" = (/turf/simulated/mineral/floor/ignore_mapgen/vacuum,/area/submap/traphouse)
"ac" = (/obj/random/unidentified_medicine/drug_den,/turf/simulated/mineral/floor/ignore_mapgen/vacuum,/area/submap/traphouse)
"ad" = (/obj/machinery/light/small,/turf/simulated/floor/tiled/steel_grid/airless,/area/submap/traphouse)
"ae" = (/turf/simulated/floor/tiled/steel_grid/airless,/area/submap/traphouse)
"af" = (/obj/machinery/access_button{command = "cycle_exterior"; frequency = 1379; layer = 3.3; master_tag = "traphouse_airlock"; name = "exterior access button"; pixel_x = 25; pixel_y = -25; req_one_access = list(12,48)},/turf/simulated/floor/tiled/steel_grid/airless,/area/submap/traphouse)
"ag" = (/turf/simulated/mineral/ignore_mapgen/vacuum,/area/submap/traphouse)
"ah" = (/turf/simulated/wall,/area/submap/traphouse)
"ai" = (/obj/machinery/door/airlock/external{frequency = 1379; icon_state = "door_locked"; id_tag = "traphouse_outer"; locked = 1; name = "Access Door"; req_access = list(13)},/turf/simulated/floor/tiled,/area/submap/traphouse)
"aj" = (/obj/machinery/atmospherics/unary/vent_pump/high_volume{dir = 2; frequency = 1379; id_tag = "traphouse_pump"},/turf/simulated/floor/tiled,/area/submap/traphouse)
"ak" = (/turf/simulated/floor/tiled,/area/submap/traphouse)
"al" = (/obj/machinery/light/small{dir = 4},/obj/machinery/atmospherics/unary/vent_pump/high_volume{dir = 2; frequency = 1379; id_tag = "traphouse_pump"},/turf/simulated/floor/tiled,/area/submap/traphouse)
"am" = (/obj/machinery/atmospherics/pipe/simple/hidden{dir = 5},/obj/machinery/embedded_controller/radio/airlock/airlock_controller{id_tag = "traphouse_airlock"; layer = 3.3; pixel_x = -25; pixel_y = 0; pixel_z = 0; tag_airpump = "traphouse_pump"; tag_chamber_sensor = "traphouse_sensor"; tag_exterior_door = "traphouse_outer"; tag_interior_door = "traphouse_inner"},/turf/simulated/floor/tiled,/area/submap/traphouse)
"an" = (/obj/machinery/atmospherics/pipe/manifold/hidden{dir = 1; icon_state = "map"},/obj/machinery/meter,/turf/simulated/floor/tiled,/area/submap/traphouse)
"ao" = (/obj/machinery/atmospherics/pipe/simple/hidden{dir = 9; icon_state = "intact"},/obj/machinery/airlock_sensor{id_tag = "traphouse_sensor"; layer = 3.3; pixel_x = 25; pixel_y = 0},/turf/simulated/floor/tiled,/area/submap/traphouse)
"ap" = (/obj/machinery/atmospherics/pipe/simple/hidden,/obj/machinery/door/airlock/external{frequency = 1379; icon_state = "door_locked"; id_tag = "traphouse_inner"; locked = 1; name = "Access Door"; req_access = list(13)},/turf/simulated/floor/tiled,/area/submap/traphouse)
"aq" = (/obj/random/unidentified_medicine/drug_den,/obj/machinery/light/small{dir = 1},/turf/simulated/floor/tiled,/area/submap/traphouse)
"ar" = (/obj/machinery/atmospherics/pipe/simple/hidden,/obj/machinery/access_button{command = "cycle_interior"; frequency = 1379; layer = 3.3; master_tag = "traphouse1_airlock"; name = "interior access button"; pixel_x = 25; pixel_y = 25; req_one_access = list(12,48)},/turf/simulated/floor/tiled,/area/submap/traphouse)
"as" = (/obj/effect/floor_decal/rust,/obj/machinery/atmospherics/portables_connector,/obj/machinery/portable_atmospherics/canister/air/airlock,/turf/simulated/floor/tiled,/area/submap/traphouse)
"at" = (/obj/machinery/atmospherics/portables_connector,/obj/machinery/portable_atmospherics/canister/air/airlock,/turf/simulated/floor/tiled,/area/submap/traphouse)
"au" = (/obj/structure/cable/green{d2 = 2; icon_state = "0-2"},/obj/machinery/power/apc{dir = 1; name = "north bump"; operating = 1; pixel_x = 0; pixel_y = 24},/obj/structure/closet/emcloset,/obj/random/contraband,/obj/random/contraband,/obj/random/contraband,/turf/simulated/floor,/area/submap/traphouse)
"av" = (/obj/machinery/atmospherics/pipe/tank/air,/turf/simulated/floor,/area/submap/traphouse)
"aw" = (/obj/effect/floor_decal/rust,/turf/simulated/floor/tiled,/area/submap/traphouse)
"ax" = (/obj/effect/floor_decal/rust,/obj/machinery/atmospherics/pipe/simple/hidden,/turf/simulated/floor/tiled,/area/submap/traphouse)
"ay" = (/obj/random/trash,/turf/simulated/floor,/area/submap/traphouse)
"az" = (/obj/structure/closet/cabinet,/obj/item/weapon/lipstick/random,/turf/simulated/floor/carpet,/area/submap/traphouse)
"aA" = (/obj/structure/bed,/obj/item/weapon/bedsheet,/obj/structure/curtain/open/bed,/turf/simulated/floor/carpet,/area/submap/traphouse)
"aB" = (/obj/structure/table/woodentable,/obj/item/weapon/reagent_containers/pill/happy{name = "pill"},/obj/item/device/flashlight/lamp,/turf/simulated/floor/carpet,/area/submap/traphouse)
"aC" = (/obj/effect/floor_decal/rust,/obj/machinery/atmospherics/pipe/simple/hidden{dir = 5},/turf/simulated/floor/tiled,/area/submap/traphouse)
"aD" = (/obj/machinery/atmospherics/pipe/manifold/hidden,/turf/simulated/floor/tiled,/area/submap/traphouse)
"aE" = (/obj/effect/floor_decal/rust,/obj/structure/cable/green{d1 = 1; d2 = 2; icon_state = "1-2"},/obj/machinery/atmospherics/pipe/simple/hidden{icon_state = "intact"; dir = 4},/turf/simulated/floor/tiled,/area/submap/traphouse)
"aF" = (/obj/machinery/atmospherics/pipe/manifold/hidden,/obj/machinery/meter,/turf/simulated/floor,/area/submap/traphouse)
"aG" = (/obj/machinery/door/airlock,/obj/machinery/atmospherics/pipe/simple/hidden{icon_state = "intact"; dir = 4},/turf/simulated/floor/tiled,/area/submap/traphouse)
"aH" = (/obj/effect/floor_decal/rust,/obj/machinery/atmospherics/pipe/simple/hidden{icon_state = "intact"; dir = 4},/turf/simulated/floor/tiled,/area/submap/traphouse)
"aI" = (/obj/machinery/atmospherics/pipe/manifold/hidden{dir = 4; icon_state = "map"},/turf/simulated/floor,/area/submap/traphouse)
"aJ" = (/obj/machinery/atmospherics/pipe/simple/hidden/supply{dir = 6},/turf/simulated/floor,/area/submap/traphouse)
"aK" = (/obj/structure/curtain/black,/obj/machinery/atmospherics/pipe/simple/hidden/supply{dir = 4},/turf/simulated/floor,/area/submap/traphouse)
"aL" = (/obj/random/trash,/obj/machinery/atmospherics/pipe/simple/hidden/supply{dir = 4},/turf/simulated/floor/carpet,/area/submap/traphouse)
"aM" = (/obj/machinery/atmospherics/pipe/simple/hidden/supply{dir = 4},/turf/simulated/floor/carpet,/area/submap/traphouse)
"aN" = (/obj/machinery/atmospherics/unary/vent_pump/on{dir = 8},/turf/simulated/floor/carpet,/area/submap/traphouse)
"aO" = (/turf/simulated/floor/carpet,/area/submap/traphouse)
"aP" = (/obj/machinery/light/small{dir = 8},/obj/structure/closet/cabinet,/obj/random/medical/pillbottle,/obj/random/medical/pillbottle,/obj/random/medical/pillbottle,/obj/random/projectile/sec,/turf/simulated/floor,/area/submap/traphouse)
"aQ" = (/obj/effect/floor_decal/rust,/obj/structure/cable/green{d1 = 1; d2 = 2; icon_state = "1-2"},/turf/simulated/floor/tiled,/area/submap/traphouse)
"aR" = (/obj/structure/closet/crate/trashcart,/turf/simulated/floor,/area/submap/traphouse)
"aS" = (/obj/effect/decal/remains/mouse,/turf/simulated/floor,/area/submap/traphouse)
"aT" = (/obj/machinery/atmospherics/pipe/simple/visible/universal,/turf/simulated/floor,/area/submap/traphouse)
"aU" = (/obj/machinery/atmospherics/pipe/simple/hidden/supply,/obj/machinery/light/small{dir = 4},/turf/simulated/floor,/area/submap/traphouse)
"aV" = (/obj/structure/closet/cabinet,/obj/item/weapon/handcuffs/fuzzy,/turf/simulated/floor/carpet,/area/submap/traphouse)
"aW" = (/obj/structure/table/woodentable,/obj/item/weapon/reagent_containers/pill/methylphenidate{name = "pill"},/turf/simulated/floor/carpet,/area/submap/traphouse)
"aX" = (/obj/structure/bed/chair/comfy/beige{icon_state = "armchair_preview"; dir = 1},/turf/simulated/floor/carpet,/area/submap/traphouse)
"aY" = (/obj/item/weapon/reagent_containers/pill/citalopram{name = "pill"},/obj/random/unidentified_medicine/drug_den,/turf/simulated/floor/carpet,/area/submap/traphouse)
"aZ" = (/obj/effect/floor_decal/rust,/obj/structure/table/woodentable,/obj/random/pizzabox,/turf/simulated/floor/tiled,/area/submap/traphouse)
"ba" = (/obj/effect/floor_decal/rust,/obj/structure/bed/chair/office/dark{dir = 8},/turf/simulated/floor/tiled,/area/submap/traphouse)
"bb" = (/obj/structure/cable/green{d1 = 1; d2 = 2; icon_state = "1-2"},/turf/simulated/floor/tiled,/area/submap/traphouse)
"bc" = (/obj/effect/floor_decal/rust,/obj/structure/table/standard,/turf/simulated/floor/tiled,/area/submap/traphouse)
"bd" = (/obj/random/junk,/turf/simulated/floor,/area/submap/traphouse)
"be" = (/obj/machinery/atmospherics/pipe/manifold/hidden/supply{dir = 8},/turf/simulated/floor,/area/submap/traphouse)
"bf" = (/obj/random/trash,/obj/machinery/atmospherics/pipe/simple/hidden/supply{dir = 9},/turf/simulated/floor,/area/submap/traphouse)
"bg" = (/obj/structure/table/woodentable,/obj/random/drinkbottle,/turf/simulated/floor/tiled,/area/submap/traphouse)
"bh" = (/obj/effect/floor_decal/rust,/obj/machinery/power/terminal{dir = 4},/obj/machinery/power/port_gen/pacman,/turf/simulated/floor/tiled,/area/submap/traphouse)
"bi" = (/obj/machinery/power/smes/buildable/point_of_interest,/obj/structure/cable/green,/turf/simulated/floor,/area/submap/traphouse)
"bj" = (/obj/structure/table/standard,/obj/random/toolbox,/turf/simulated/floor/tiled,/area/submap/traphouse)
"bk" = (/turf/simulated/floor,/area/submap/traphouse)
"bl" = (/obj/machinery/atmospherics/pipe/simple/hidden/supply,/turf/simulated/floor,/area/submap/traphouse)
"bm" = (/obj/structure/closet/cabinet,/obj/item/weapon/contraband/poster,/turf/simulated/floor/carpet,/area/submap/traphouse)
"bn" = (/obj/structure/bed/chair/comfy/beige,/turf/simulated/floor/carpet,/area/submap/traphouse)
"bo" = (/obj/structure/table/woodentable,/obj/item/device/flashlight/lamp,/obj/item/weapon/reagent_containers/syringe/drugs,/turf/simulated/floor/carpet,/area/submap/traphouse)
"bp" = (/obj/structure/bed/chair/comfy/beige,/obj/item/weapon/reagent_containers/pill/citalopram{name = "pill"},/turf/simulated/floor/carpet,/area/submap/traphouse)
"bq" = (/obj/structure/loot_pile/maint/junk,/turf/simulated/floor,/area/submap/traphouse)
"br" = (/obj/effect/floor_decal/rust,/obj/machinery/atmospherics/pipe/simple/hidden/supply{dir = 4},/turf/simulated/floor/tiled,/area/submap/traphouse)
"bs" = (/obj/machinery/atmospherics/pipe/simple/hidden/supply{dir = 4},/obj/random/unidentified_medicine/drug_den,/turf/simulated/floor/carpet,/area/submap/traphouse)
"bt" = (/obj/item/weapon/reagent_containers/pill/citalopram{name = "pill"},/obj/item/weapon/reagent_containers/pill/citalopram{name = "pill"},/turf/simulated/floor/carpet,/area/submap/traphouse)
"bu" = (/obj/structure/table/standard,/obj/item/weapon/storage/pill_bottle/happy,/turf/simulated/floor/tiled,/area/submap/traphouse)
"bv" = (/obj/structure/table/standard,/obj/item/stack/medical/splint,/turf/simulated/floor/tiled,/area/submap/traphouse)
"bw" = (/obj/structure/table/standard,/obj/item/weapon/reagent_containers/pill/citalopram,/obj/item/weapon/reagent_containers/pill/citalopram,/turf/simulated/floor/tiled,/area/submap/traphouse)
"bx" = (/obj/structure/table/standard,/obj/item/weapon/reagent_containers/pill/tramadol,/obj/item/weapon/reagent_containers/pill/tramadol,/turf/simulated/floor/tiled,/area/submap/traphouse)
"by" = (/obj/machinery/light/small{dir = 4},/turf/simulated/floor/tiled,/area/submap/traphouse)
"bz" = (/obj/structure/closet/cabinet,/obj/item/clothing/accessory/jacket,/obj/item/weapon/material/butterfly/switchblade,/turf/simulated/floor/carpet,/area/submap/traphouse)
"bA" = (/obj/item/weapon/reagent_containers/pill/zoom{name = "pill"},/obj/random/trash,/obj/random/unidentified_medicine/drug_den,/turf/simulated/floor/carpet,/area/submap/traphouse)
"bB" = (/obj/item/weapon/reagent_containers/pill/zoom{name = "pill"},/turf/simulated/floor/carpet,/area/submap/traphouse)
"bC" = (/obj/structure/loot_pile/maint/boxfort,/turf/simulated/floor/carpet,/area/submap/traphouse)
"bD" = (/obj/structure/table/standard,/obj/item/weapon/surgical/scalpel,/turf/simulated/floor/tiled,/area/submap/traphouse)
"bE" = (/obj/structure/table/standard,/obj/random/firstaid,/turf/simulated/floor,/area/submap/traphouse)
"bF" = (/obj/random/unidentified_medicine/drug_den,/turf/simulated/floor,/area/submap/traphouse)
"bG" = (/obj/machinery/atmospherics/pipe/simple/hidden/supply,/turf/simulated/floor/tiled,/area/submap/traphouse)
"bH" = (/obj/structure/loot_pile/maint/junk,/turf/simulated/floor/tiled,/area/submap/traphouse)
"bI" = (/obj/effect/floor_decal/rust,/obj/structure/table/standard,/obj/random/unidentified_medicine/drug_den,/obj/machinery/light/small{dir = 8},/turf/simulated/floor/tiled,/area/submap/traphouse)
"bJ" = (/obj/machinery/atmospherics/unary/vent_pump/on,/turf/simulated/floor,/area/submap/traphouse)
"bK" = (/obj/structure/table/standard,/obj/item/weapon/reagent_containers/pill/zoom,/obj/item/weapon/reagent_containers/pill/zoom,/turf/simulated/floor,/area/submap/traphouse)
"bL" = (/obj/structure/closet/cabinet,/obj/random/projectile/scrapped_gun,/obj/random/toy,/turf/simulated/floor/carpet,/area/submap/traphouse)
"bM" = (/obj/structure/table/woodentable,/obj/item/weapon/reagent_containers/pill/tramadol{name = "pill"},/obj/random/unidentified_medicine/drug_den,/turf/simulated/floor/carpet,/area/submap/traphouse)
"bN" = (/obj/structure/bed/chair/comfy/beige,/obj/random/unidentified_medicine/drug_den,/turf/simulated/floor/carpet,/area/submap/traphouse)
"bO" = (/obj/item/wheelchair,/turf/simulated/floor,/area/submap/traphouse)
"bP" = (/obj/machinery/atmospherics/pipe/simple/hidden/supply{dir = 5},/turf/simulated/floor,/area/submap/traphouse)
"bQ" = (/obj/machinery/atmospherics/pipe/simple/hidden/supply{dir = 4},/turf/simulated/floor,/area/submap/traphouse)
"bR" = (/obj/machinery/door/airlock,/obj/machinery/atmospherics/pipe/simple/hidden/supply{dir = 4},/turf/simulated/floor,/area/submap/traphouse)
"bS" = (/obj/machinery/atmospherics/pipe/manifold/hidden/supply,/turf/simulated/floor,/area/submap/traphouse)
"bT" = (/obj/structure/girder,/turf/simulated/floor,/area/submap/traphouse)
"bU" = (/obj/item/weapon/material/shard,/turf/simulated/floor,/area/submap/traphouse)
"bV" = (/obj/random/trash,/obj/machinery/light/small{dir = 4},/turf/simulated/floor,/area/submap/traphouse)
"bW" = (/obj/structure/closet/cabinet,/obj/random/mre,/obj/random/medical/lite,/turf/simulated/floor/carpet,/area/submap/traphouse)
"bX" = (/obj/structure/table/woodentable,/obj/item/device/flashlight/lamp,/turf/simulated/floor/carpet,/area/submap/traphouse)
"bY" = (/obj/structure/table/woodentable,/obj/item/weapon/reagent_containers/syringe/drugs,/obj/random/unidentified_medicine/drug_den,/turf/simulated/floor/carpet,/area/submap/traphouse)
"bZ" = (/obj/random/trash,/turf/simulated/floor/carpet,/area/submap/traphouse)
"ca" = (/obj/random/junk,/obj/random/unidentified_medicine/drug_den,/turf/simulated/floor,/area/submap/traphouse)
"cb" = (/obj/item/weapon/vehicle_assembly/spacebike,/turf/simulated/mineral/floor/ignore_mapgen/vacuum,/area/submap/traphouse)
"cc" = (/mob/living/simple_mob/animal/space/bats,/turf/simulated/mineral/floor/ignore_mapgen/vacuum,/area/submap/traphouse)
"cd" = (/obj/structure/loot_pile/maint/junk,/turf/simulated/mineral/floor/ignore_mapgen/vacuum,/area/submap/traphouse)
"ce" = (/obj/structure/loot_pile/maint/boxfort,/turf/simulated/mineral/floor/ignore_mapgen/vacuum,/area/submap/traphouse)

(1,1,1) = {"
aaaaaaaaaaaaaaaaaaaaaaaaaaaaaaaaaaaaaaaaaaaaaaaaaa
aaaaaaaaaaaaaaaaaaaaababababaaaaaaaaaaaaaaaaaaaaaa
aaaaaaaaaaaaaaaaababccabababababaaaaaaaaaaaaaaaaaa
aaaaaaaaaaaaababacababadaeafaeadababaaaaaaaaaaaaaa
aaaaaaagagagagagcdababahahaiahahabacababaaaaaaaaaa
aaaaaaagagagagagagcbceahajakalahcdagagagagaaaaaaaa
aaaaagagagagagagagagagahamanaoahagagagagagagaaaaaa
aaaaagagagagagagagagagahahapahahagagagagagagagaaaa
aaaaagagagagahahahahahahaqarakahahahahahahagagaaaa
aaaaagagagagahasatauavahawaxayahazaAaBaAahagagagaa
aaaaagagagagahaCaDaEaFaGaHaIaJaKaLaMaNaOahagagagaa
aaaaagagagagahaPawaQaRahaSaTaUahaVaWaXaYahagagagaa
aaaaagagagagahaZbabbbcahbdbebfahahahahahahagagagaa
aaaaagagagagahbgbhbibjahbkblbkahbmbnbobpahagagaaaa
aaagagagagagahahahahahahbqbebraKaMbsaNbtahagagaaaa
aaagagagagagahbubvbwbxahbkblbyahbzbAbBbCahagagaaaa
aaagagagagagahbDakawbEahbFbGbHahahahahahahagagaaaa
aaaaagagagagahbIbkbJbKahayblawahbLbMbnbNahagagagaa
aaaaaaagagagahbObkbPbQbRbQbSbQaKaMaMaNaOahagagagaa
aaaaaaagagagahbTbkbUbkahbkbkbVahbWbXbYbZahagagagaa
aaaaaaagagagahahahahahahbTcaahahahahahahahagagagaa
aaaaaaagagagagagagagagagagagagagagagagagagagagaaaa
aaaaaaaaagagagagagagagagagagagagagagagagagagagaaaa
aaaaaaaaaaagagagagagaaaaaaaaaaagagagagaaagagaaaaaa
aaaaaaaaaaaaaaaaaaaaaaaaaaaaaaaaaaaaaaaaaaaaaaaaaa
"}
