"aa" = (/turf/space,/area/space)
"ab" = (/turf/simulated/shuttle/wall,/area/space)
"ac" = (/turf/unsimulated/wall{desc = "That looks like it doesn't open easily."; dir = 8; icon = 'icons/obj/doors/rapid_pdoor.dmi'; icon_state = "pdoor1"; name = "Shuttle Bay Blast Door"},/area/space)
"ad" = (/turf/simulated/shuttle/plating,/area/space)
"ae" = (/turf/space,/obj/structure/shuttle/engine/propulsion{icon_state = "propulsion_r"; dir = 1},/turf/simulated/shuttle/plating/airless/carry,/area/space)
"af" = (/turf/space,/obj/structure/shuttle/engine/propulsion{icon_state = "propulsion"; dir = 1},/turf/simulated/shuttle/plating/airless/carry,/area/space)
"ag" = (/turf/space,/obj/structure/shuttle/engine/propulsion{icon_state = "propulsion_l"; dir = 1},/turf/simulated/shuttle/plating/airless/carry,/area/space)
"ah" = (/obj/structure/shuttle/engine/heater{icon_state = "heater"; dir = 1},/obj/structure/window/reinforced,/turf/simulated/shuttle/plating/airless,/area/space)
"ai" = (/obj/machinery/door/airlock/external{frequency = 1380; icon_state = "door_locked"; id_tag = "escape_pod_1_recovery_hatch"; locked = 1; name = "Recovery Shuttle Dock 1"; req_access = list(13)},/turf/simulated/shuttle/floor/black,/area/space)
"aj" = (/obj/machinery/door/airlock/external{frequency = 1380; icon_state = "door_locked"; id_tag = "escape_pod_2_recovery_hatch"; locked = 1; name = "Recovery Shuttle Dock 2"; req_access = list(13)},/turf/simulated/shuttle/floor/black,/area/space)
"ak" = (/obj/structure/window/reinforced{dir = 1; health = 1e+006},/obj/structure/table/rack,/obj/item/weapon/reagent_containers/spray/cleaner,/turf/simulated/shuttle/plating,/area/space)
"al" = (/obj/structure/window/reinforced{dir = 1; health = 1e+006},/turf/simulated/shuttle/plating,/area/space)
"am" = (/obj/structure/closet/emcloset,/turf/simulated/shuttle/floor/yellow,/area/space)
"an" = (/turf/simulated/shuttle/floor/yellow,/area/space)
"ao" = (/obj/machinery/embedded_controller/radio/simple_docking_controller{frequency = 1380; id_tag = "escape_pod_1_recovery"; pixel_x = -25; pixel_y = 25; req_one_access = list(13); tag_door = "escape_pod_1_recovery_hatch"},/turf/simulated/shuttle/floor/yellow,/area/space)
"ap" = (/obj/machinery/embedded_controller/radio/simple_docking_controller{frequency = 1380; id_tag = "escape_pod_2_recovery"; pixel_x = -25; pixel_y = 25; req_one_access = list(13); tag_door = "escape_pod_2_recovery_hatch"},/turf/simulated/shuttle/floor/yellow,/area/space)
"aq" = (/obj/structure/window/reinforced{dir = 1; health = 1e+006},/obj/machinery/portable_atmospherics/canister/oxygen,/turf/simulated/shuttle/plating,/area/space)
"ar" = (/obj/structure/mopbucket,/obj/item/weapon/mop,/turf/simulated/shuttle/plating,/area/space)
"as" = (/obj/machinery/door/airlock/maintenance_hatch{req_access = list(101)},/turf/simulated/shuttle/floor/black,/area/space)
"at" = (/turf/simulated/shuttle/floor,/area/space)
"au" = (/obj/structure/bed/padded,/obj/item/weapon/bedsheet/medical,/turf/simulated/shuttle/floor,/area/space)
"av" = (/obj/structure/window/reinforced{dir = 8; health = 1e+006},/obj/structure/closet/secure_closet/personal,/turf/simulated/shuttle/floor,/area/space)
"aw" = (/obj/structure/window/reinforced{dir = 4; health = 1e+006},/obj/structure/closet/secure_closet/personal,/turf/simulated/shuttle/floor,/area/space)
"ax" = (/obj/machinery/portable_atmospherics/powered/scrubber,/turf/simulated/shuttle/plating,/area/space)
"ay" = (/obj/structure/reagent_dispensers/watertank,/obj/item/weapon/reagent_containers/glass/bucket,/turf/simulated/shuttle/plating,/area/space)
"az" = (/obj/machinery/vending/engineering,/turf/simulated/shuttle/plating,/area/space)
"aA" = (/obj/machinery/portable_atmospherics/powered/pump,/turf/simulated/shuttle/plating,/area/space)
"aB" = (/turf/simulated/shuttle/wall/hard_corner,/area/space)
"aC" = (/turf/unsimulated/wall{desc = "That looks like it doesn't open easily."; icon = 'icons/obj/doors/rapid_pdoor.dmi'; icon_state = "pdoor1"; name = "Shuttle Bay Blast Door"},/area/space)
"aD" = (/obj/machinery/door/airlock/external{frequency = 1380; icon_state = "door_locked"; id_tag = "escape_pod_7_recovery_hatch"; locked = 1; name = "Recovery Shuttle Dock 7"; req_access = list(13)},/turf/simulated/shuttle/floor/black,/area/space)
"aE" = (/obj/machinery/embedded_controller/radio/simple_docking_controller{frequency = 1380; id_tag = "escape_pod_7_recovery"; pixel_x = -26; pixel_y = 26; req_one_access = list(13); tag_door = "escape_pod_7_recovery_hatch"},/turf/simulated/shuttle/floor/yellow,/area/space)
"aF" = (/obj/machinery/embedded_controller/radio/simple_docking_controller{frequency = 1380; id_tag = "escape_pod_8_recovery"; pixel_x = 26; pixel_y = -26; req_one_access = list(13); tag_door = "escape_pod_8_recovery_hatch"},/turf/simulated/shuttle/floor/yellow,/area/space)
"aG" = (/obj/machinery/door/airlock/external{frequency = 1380; icon_state = "door_locked"; id_tag = "escape_pod_8_recovery_hatch"; locked = 1; name = "Recovery Shuttle Dock 8"; req_access = list(13)},/turf/simulated/shuttle/floor/black,/area/space)
"aH" = (/turf/simulated/shuttle/wall/no_join{base_state = "orange"; icon = 'icons/turf/shuttle_orange.dmi'; icon_state = "orange"},/area/space)
"aI" = (/obj/structure/bed,/obj/item/weapon/bedsheet/orange,/turf/simulated/shuttle/plating,/area/space)
"aJ" = (/turf/simulated/shuttle/wall/dark/no_join,/area/space)
"aK" = (/obj/structure/closet/secure_closet/security,/turf/simulated/shuttle/floor{icon_state = "floor_red"},/area/space)
"aL" = (/obj/structure/closet{name = "Evidence Closet"},/turf/simulated/shuttle/floor{icon_state = "floor_red"},/area/space)
"aM" = (/obj/structure/table/reinforced,/obj/item/weapon/paper_bin,/obj/item/weapon/pen,/turf/simulated/shuttle/floor{icon_state = "floor_red"},/area/space)
"aN" = (/obj/structure/table/rack,/turf/simulated/shuttle/floor{icon_state = "floor_red"},/area/space)
"aO" = (/obj/structure/shuttle/window,/obj/structure/grille,/turf/simulated/shuttle/plating,/area/space)
"aP" = (/obj/machinery/door/airlock/glass,/turf/simulated/shuttle/floor,/area/space)
"aQ" = (/turf/simulated/shuttle/floor{icon_state = "floor_red"},/area/space)
"aR" = (/obj/machinery/door/airlock/glass_security{name = "Escape Shuttle Cell"; req_access = list(1)},/turf/simulated/shuttle/plating,/area/space)
"aS" = (/obj/machinery/door/airlock/glass_security{name = "Security Processing"; req_access = list(1)},/turf/simulated/shuttle/floor{icon_state = "floor_red"},/area/space)
"aT" = (/obj/structure/bed/chair,/turf/simulated/shuttle/floor{icon_state = "floor_red"},/area/space)
"aU" = (/obj/machinery/computer/card{dir = 1},/turf/simulated/shuttle/floor{icon_state = "floor_red"},/area/space)
"aV" = (/obj/machinery/computer/secure_data{dir = 1},/turf/simulated/shuttle/floor{icon_state = "floor_red"},/area/space)
"aW" = (/obj/machinery/door/airlock/external{frequency = 1380; icon_state = "door_locked"; id_tag = "large_escape_pod_2_recovery_hatch"; locked = 1; name = "Recovery Shuttle Dock 02"; req_access = list(13)},/turf/simulated/shuttle/floor/black,/area/space)
"aX" = (/obj/machinery/door/blast/regular{icon_state = "pdoor1"; id = "CREED"; name = "Ready Room"; p_open = 0},/turf/simulated/shuttle/floor,/area/space)
"aY" = (/obj/machinery/embedded_controller/radio/simple_docking_controller{frequency = 1380; id_tag = "large_escape_pod_2_recovery"; pixel_x = -25; pixel_y = 25; req_one_access = list(13); tag_door = "large_escape_pod_2_recovery_hatch"},/turf/simulated/shuttle/floor/yellow,/area/space)
"aZ" = (/obj/structure/table/standard,/turf/simulated/shuttle/floor/yellow,/area/space)
"ba" = (/obj/machinery/door/airlock/external,/turf/simulated/shuttle/floor,/area/space)
"bb" = (/obj/machinery/embedded_controller/radio/simple_docking_controller{frequency = 1380; id_tag = "large_escape_pod_1_recovery"; pixel_x = -25; pixel_y = -25; req_one_access = list(13); tag_door = "large_escape_pod_1_recovery_hatch"},/turf/simulated/shuttle/floor/yellow,/area/space)
"bc" = (/obj/machinery/door/airlock/external{frequency = 1380; icon_state = "door_locked"; id_tag = "large_escape_pod_1_recovery_hatch"; locked = 1; name = "Recovery Shuttle Dock 01"; req_access = list(13)},/turf/simulated/shuttle/floor/black,/area/space)
"bd" = (/obj/structure/table/standard,/obj/item/weapon/towel,/obj/item/weapon/towel,/obj/item/weapon/towel,/obj/item/weapon/towel,/obj/random/soap,/obj/random/soap,/turf/simulated/shuttle/floor/white,/area/space)
"be" = (/obj/machinery/recharge_station,/turf/simulated/shuttle/floor/white,/area/space)
"bf" = (/obj/structure/toilet,/turf/simulated/shuttle/floor/white,/area/space)
"bg" = (/obj/structure/sink{icon_state = "sink"; dir = 8; pixel_x = -12; pixel_y = 2},/obj/structure/mirror{pixel_x = -28},/turf/simulated/shuttle/floor/white,/area/space)
"bh" = (/obj/structure/extinguisher_cabinet{pixel_x = 28; pixel_y = 0},/turf/simulated/shuttle/floor/white,/area/space)
"bi" = (/obj/machinery/door/airlock{name = "Unit 1"},/turf/simulated/shuttle/floor/white,/area/space)
"bj" = (/obj/machinery/door/airlock/external{frequency = 1380; icon_state = "door_locked"; id_tag = "cryostorage_shuttle_recovery_hatch"; locked = 1; name = "Recovery Shuttle Dock Cryostorage"; req_access = list(13)},/turf/simulated/shuttle/floor/black,/area/space)
"bk" = (/obj/machinery/embedded_controller/radio/simple_docking_controller{frequency = 1380; id_tag = "cryostorage_shuttle_recovery"; pixel_x = -26; pixel_y = 26; req_one_access = list(13); tag_door = "cryostorage_shuttle_recovery_hatch"},/turf/simulated/shuttle/floor,/area/space)
"bl" = (/obj/machinery/door/airlock{name = "Unisex Restrooms"},/turf/simulated/shuttle/floor,/area/space)
"bm" = (/obj/machinery/door/airlock{name = "Unisex Showers"},/turf/simulated/shuttle/floor/white,/area/space)
"bn" = (/obj/machinery/shower{dir = 4; icon_state = "shower"; pixel_x = 5; pixel_y = 0},/obj/structure/curtain/open/shower,/turf/simulated/shuttle/floor/white,/area/space)
"bo" = (/turf/simulated/shuttle/floor/white,/area/space)
"bp" = (/obj/machinery/shower{dir = 8; icon_state = "shower"; pixel_x = -5; pixel_y = -1},/obj/structure/curtain/open/shower,/turf/simulated/shuttle/floor/white,/area/space)
"bq" = (/obj/machinery/door/airlock,/turf/simulated/shuttle/floor,/area/space)
"br" = (/obj/item/weapon/bikehorn/rubberducky,/turf/simulated/shuttle/floor/white,/area/space)
"bs" = (/obj/structure/closet/secure_closet/personal,/turf/simulated/shuttle/floor,/area/space)
"bt" = (/obj/machinery/door/airlock/external{frequency = 1380; icon_state = "door_locked"; id_tag = "escape_pod_4_recovery_hatch"; locked = 1; name = "Recovery Shuttle Dock 4"; req_access = list(13)},/turf/simulated/shuttle/floor/black,/area/space)
"bu" = (/obj/machinery/embedded_controller/radio/simple_docking_controller{frequency = 1380; id_tag = "escape_pod_4_recovery"; pixel_x = -26; pixel_y = 26; req_one_access = list(13); tag_door = "escape_pod_4_recovery_hatch"},/turf/simulated/shuttle/floor/yellow,/area/space)
"bv" = (/obj/machinery/embedded_controller/radio/simple_docking_controller{frequency = 1380; id_tag = "escape_pod_6_recovery"; pixel_x = 26; pixel_y = -26; req_one_access = list(13); tag_door = "escape_pod_6_recovery_hatch"},/turf/simulated/shuttle/floor/yellow,/area/space)
"bw" = (/obj/machinery/door/airlock/external{frequency = 1380; icon_state = "door_locked"; id_tag = "escape_pod_6_recovery_hatch"; locked = 1; name = "Recovery Shuttle Dock 6"; req_access = list(13)},/turf/simulated/shuttle/floor/black,/area/space)
"bx" = (/obj/structure/bed/chair,/turf/simulated/shuttle/floor,/area/space)
"by" = (/obj/structure/table/standard,/turf/simulated/shuttle/floor,/area/space)
"bz" = (/obj/machinery/door/airlock/external{frequency = 1380; icon_state = "door_locked"; id_tag = "escape_pod_3_recovery_hatch"; locked = 1; name = "Recovery Shuttle Dock 3"; req_access = list(13)},/turf/simulated/shuttle/floor/black,/area/space)
"bA" = (/obj/machinery/embedded_controller/radio/simple_docking_controller{frequency = 1380; id_tag = "escape_pod_3_recovery"; pixel_x = -26; pixel_y = 26; req_one_access = list(13); tag_door = "escape_pod_3_recovery_hatch"},/turf/simulated/shuttle/floor/yellow,/area/space)
"bB" = (/obj/structure/bed/chair{dir = 1},/turf/simulated/shuttle/floor,/area/space)
"bC" = (/obj/machinery/embedded_controller/radio/simple_docking_controller{frequency = 1380; id_tag = "escape_pod_5_recovery"; pixel_x = 26; pixel_y = -26; req_one_access = list(13); tag_door = "escape_pod_5_recovery_hatch"},/turf/simulated/shuttle/floor/yellow,/area/space)
"bD" = (/obj/machinery/door/airlock/external{frequency = 1380; icon_state = "door_locked"; id_tag = "escape_pod_5_recovery_hatch"; locked = 1; name = "Recovery Shuttle Dock 5"; req_access = list(13)},/turf/simulated/shuttle/floor/black,/area/space)
"bE" = (/obj/machinery/vending/snack,/turf/simulated/shuttle/floor/yellow,/area/space)
"bF" = (/obj/machinery/vending/coffee,/turf/simulated/shuttle/floor/yellow,/area/space)
"bG" = (/obj/machinery/vending/cola,/turf/simulated/shuttle/floor/yellow,/area/space)
"bH" = (/obj/machinery/vending/cigarette,/turf/simulated/shuttle/floor/yellow,/area/space)
"bI" = (/obj/machinery/computer/crew,/turf/simulated/shuttle/floor/white,/area/space)
"bJ" = (/obj/machinery/bodyscanner{dir = 8},/turf/simulated/shuttle/floor/white,/area/space)
"bK" = (/obj/machinery/body_scanconsole,/turf/simulated/shuttle/floor/white,/area/space)
"bL" = (/obj/machinery/atmospherics/portables_connector,/obj/machinery/portable_atmospherics/canister/oxygen/prechilled,/turf/simulated/shuttle/floor/white,/area/space)
"bM" = (/obj/machinery/atmospherics/unary/cryo_cell{layer = 3.3},/turf/simulated/shuttle/floor/white,/area/space)
"bN" = (/obj/machinery/atmospherics/unary/freezer{dir = 2; icon_state = "freezer"},/turf/simulated/shuttle/floor/white,/area/space)
"bO" = (/obj/structure/bed/chair{dir = 1},/turf/simulated/shuttle/floor/white,/area/space)
"bP" = (/obj/machinery/iv_drip,/turf/simulated/shuttle/floor/white,/area/space)
"bQ" = (/obj/structure/bed/roller,/turf/simulated/shuttle/floor/white,/area/space)
"bR" = (/obj/item/weapon/reagent_containers/glass/beaker/cryoxadone{pixel_x = -4; pixel_y = 0},/obj/item/weapon/tool/wrench,/obj/structure/table/reinforced,/obj/item/weapon/reagent_containers/glass/beaker/cryoxadone,/turf/simulated/shuttle/floor/white,/area/space)
"bS" = (/obj/machinery/atmospherics/pipe/simple/visible{icon_state = "intact"; dir = 5},/turf/simulated/shuttle/floor/white,/area/space)
"bT" = (/obj/machinery/atmospherics/pipe/manifold/visible,/turf/simulated/shuttle/floor/white,/area/space)
"bU" = (/obj/machinery/atmospherics/pipe/simple/visible{icon_state = "intact"; dir = 9},/turf/simulated/shuttle/floor/white,/area/space)
"bV" = (/obj/machinery/door/airlock/glass,/turf/simulated/shuttle/floor/white,/area/space)
"bW" = (/obj/machinery/vending/wallmed1{name = "Emergency NanoMed"; pixel_x = -30; pixel_y = 0},/obj/structure/table/standard,/obj/item/device/defib_kit,/obj/item/device/defib_kit,/obj/machinery/recharger,/obj/item/weapon/tool/screwdriver,/turf/simulated/shuttle/floor/white,/area/space)
"bX" = (/obj/machinery/sleeper{dir = 8},/turf/simulated/shuttle/floor/white,/area/space)
"bY" = (/obj/machinery/sleep_console,/turf/simulated/shuttle/floor/white,/area/space)
"bZ" = (/obj/structure/closet/crate/medical,/obj/item/weapon/surgical/circular_saw,/obj/item/weapon/surgical/surgicaldrill,/obj/item/weapon/surgical/bonegel{pixel_x = 4; pixel_y = 3},/obj/item/weapon/surgical/bonesetter,/obj/item/weapon/surgical/scalpel,/obj/item/weapon/surgical/retractor{pixel_x = 0; pixel_y = 6},/obj/item/weapon/surgical/hemostat{pixel_y = 4},/obj/item/weapon/surgical/cautery{pixel_y = 4},/obj/item/weapon/surgical/FixOVein{pixel_x = -6; pixel_y = 1},/obj/item/stack/nanopaste,/obj/item/weapon/tank/anesthetic,/obj/item/clothing/mask/breath/medical,/obj/item/clothing/mask/surgical,/obj/item/clothing/mask/surgical,/turf/simulated/shuttle/floor/white,/area/space)
"ca" = (/obj/machinery/door/airlock/hatch{name = "Cockpit"; req_access = list(109)},/turf/simulated/shuttle/floor/black,/area/space)
"cb" = (/obj/structure/table/reinforced,/obj/item/weapon/storage/box/bodybags{pixel_x = 2; pixel_y = 2},/obj/item/weapon/storage/box/bodybags,/turf/simulated/shuttle/floor/white,/area/space)
"cc" = (/obj/structure/closet/crate/freezer,/obj/item/weapon/reagent_containers/food/snacks/meat/syntiflesh,/obj/item/weapon/reagent_containers/food/snacks/meat/syntiflesh,/obj/item/weapon/reagent_containers/food/snacks/meat/syntiflesh,/obj/item/weapon/reagent_containers/food/snacks/meat/syntiflesh,/obj/item/weapon/reagent_containers/food/snacks/meat/syntiflesh,/obj/item/weapon/reagent_containers/food/snacks/meat/syntiflesh,/obj/item/weapon/reagent_containers/food/snacks/meat/syntiflesh,/obj/item/weapon/reagent_containers/food/snacks/meat/syntiflesh,/obj/item/weapon/reagent_containers/food/snacks/meat/syntiflesh,/turf/simulated/shuttle/floor/white,/area/space)
"cd" = (/obj/machinery/clonepod,/turf/simulated/shuttle/floor/white,/area/space)
"ce" = (/obj/machinery/computer/cloning{dir = 1},/turf/simulated/shuttle/floor/white,/area/space)
"cf" = (/obj/machinery/dna_scannernew,/turf/simulated/shuttle/floor/white,/area/space)
"cg" = (/obj/machinery/optable,/turf/simulated/shuttle/floor/white,/area/space)
"ch" = (/obj/machinery/computer/crew,/turf/simulated/shuttle/floor/black,/area/space)
"ci" = (/obj/structure/bed/chair{dir = 8},/turf/simulated/shuttle/floor/black,/area/space)
"cj" = (/turf/simulated/shuttle/floor/black,/area/space)
"ck" = (/obj/structure/bed/chair{dir = 4},/turf/simulated/shuttle/floor/black,/area/space)
"cl" = (/obj/machinery/computer/communications,/turf/simulated/shuttle/floor/black,/area/space)
"cm" = (/obj/machinery/door/airlock/medical{name = "Morgue"; req_access = list(6)},/turf/simulated/shuttle/floor/white,/area/space)
"cn" = (/obj/machinery/computer/operating{dir = 4},/turf/simulated/shuttle/floor/white,/area/space)
"co" = (/obj/structure/bed/chair,/turf/simulated/shuttle/floor/black,/area/space)
"cp" = (/obj/structure/morgue,/turf/simulated/shuttle/floor/white,/area/space)
"cq" = (/obj/structure/morgue{icon_state = "morgue1"; dir = 8},/turf/simulated/shuttle/floor/white,/area/space)
"cr" = (/obj/structure/closet/crate/medical,/obj/item/weapon/storage/firstaid/regular{pixel_x = -2; pixel_y = 4},/obj/item/weapon/storage/firstaid/regular{pixel_x = -2; pixel_y = 4},/obj/item/bodybag/cryobag{pixel_x = 5},/obj/item/bodybag/cryobag{pixel_x = 5},/obj/item/weapon/storage/firstaid/o2{layer = 2.8; pixel_x = 4; pixel_y = 6},/obj/item/weapon/storage/box/masks{pixel_x = 0; pixel_y = 0},/obj/item/weapon/storage/box/gloves{pixel_x = 3; pixel_y = 4},/obj/item/weapon/storage/firstaid/toxin,/obj/item/weapon/storage/firstaid/fire{layer = 2.9; pixel_x = 2; pixel_y = 3},/obj/item/weapon/storage/firstaid/adv{pixel_x = -2},/obj/item/weapon/reagent_containers/blood/empty,/obj/item/weapon/reagent_containers/blood/empty,/turf/simulated/shuttle/floor/white,/area/space)
"cs" = (/obj/structure/table/standard,/obj/item/weapon/storage/firstaid/regular{pixel_x = 2; pixel_y = 0},/obj/item/weapon/storage/firstaid/regular{pixel_x = -2; pixel_y = 4},/turf/simulated/shuttle/floor/white,/area/space)
"ct" = (/obj/structure/table/standard,/obj/item/weapon/storage/firstaid/fire,/obj/item/weapon/storage/firstaid/fire{pixel_x = -2; pixel_y = 4},/turf/simulated/shuttle/floor/white,/area/space)
"cu" = (/obj/structure/table/standard,/obj/item/weapon/storage/firstaid/toxin{pixel_x = -2; pixel_y = 4},/obj/item/weapon/storage/firstaid/toxin,/turf/simulated/shuttle/floor/white,/area/space)
"cv" = (/obj/structure/table/reinforced,/obj/item/weapon/reagent_containers/blood/OMinus,/obj/item/weapon/reagent_containers/blood/OMinus,/obj/item/weapon/reagent_containers/blood/OMinus,/obj/item/weapon/reagent_containers/blood/OMinus,/obj/item/weapon/reagent_containers/blood/OMinus,/obj/item/weapon/reagent_containers/blood/OMinus,/turf/simulated/shuttle/floor/white,/area/space)
"cw" = (/obj/structure/table/standard,/obj/item/weapon/clipboard,/obj/item/weapon/pen,/obj/item/weapon/stamp/captain,/turf/simulated/shuttle/floor/black,/area/space)
"cx" = (/obj/machinery/computer/shuttle{dir = 1},/turf/simulated/shuttle/floor/black,/area/space)
"cy" = (/obj/structure/table/standard,/obj/item/weapon/storage/lockbox,/turf/simulated/shuttle/floor/black,/area/space)
"cz" = (/obj/machinery/computer/station_alert{dir = 1},/turf/simulated/shuttle/floor/black,/area/space)
"cA" = (/obj/structure/table/standard,/obj/item/device/radio/off,/obj/item/weapon/paper_bin,/turf/simulated/shuttle/floor/black,/area/space)
"cB" = (/obj/structure/grille,/obj/structure/shuttle/window,/turf/simulated/shuttle/plating,/area/space)

(1,1,1) = {"
aaaaaaaaaaaaaaaaaaaaaaaaaaaaaaaaaaaaaaaaaaaaaaaaaaaaaaaaaaaaaaaaaaaaaaaaaaaaaaaaaaaaaaaaaaaaaaaaaaaa
aaaaaaaaaaaaaaaaaaaaaaaaaaaaaaaaaaaaaaaaaaaaaaaaaaaaaaaaaaaaaaaaaaaaaaaaaaaaaaaaaaaaaaaaaaaaaaaaaaaa
aaaaaaaaaaaaaaaaaaaaaaaaaaaaaaaaaaaaaaaaaaaaaaaaaaaaaaaaaaaaaaaaaaaaaaaaaaaaaaaaaaaaaaaaaaaaaaaaaaaa
aaaaaaaaaaaaaaaaaaaaaaaaaaaaaaaaaaaaaaaaaaaaaaaaaaaaaaaaaaaaaaaaaaaaaaaaaaaaaaaaaaaaaaaaaaaaaaaaaaaa
aaaaaaaaaaaaaaaaaaaaaaaaaaaaaaaaaaaaaaaaaaaaaaaaaaaaaaaaaaaaaaaaaaaaaaaaaaaaaaaaaaaaaaaaaaaaaaaaaaaa
aaaaaaaaaaaaaaaaaaaaaaaaaaaaaaaaaaaaaaaaaaaaaaaaaaaaaaaaaaaaaaaaaaaaaaaaaaaaaaaaaaaaaaaaaaaaaaaaaaaa
aaaaaaaaaaaaaaaaaaaaaaaaaaaaaaaaaaaaaaaaaaaaaaaaaaaaaaaaaaaaaaaaaaaaaaaaaaaaaaaaaaaaaaaaaaaaaaaaaaaa
aaaaaaaaaaaaaaaaaaaaaaaaaaaaaaaaaaaaaaaaaaaaaaaaaaaaaaaaaaaaaaaaaaaaaaaaaaaaaaaaaaaaaaaaaaaaaaaaaaaa
aaaaaaaaaaaaaaaaaaaaaaaaaaaaaaaaaaaaaaaaaaaaaaaaaaaaaaaaaaaaaaaaaaaaaaaaaaaaaaaaaaaaaaaaaaaaaaaaaaaa
aaaaaaaaaaaaaaaaaaaaaaaaaaaaaaaaaaaaaaaaaaaaaaaaaaaaaaaaaaaaaaaaaaaaaaaaaaaaaaaaaaaaaaaaaaaaaaaaaaaa
aaaaaaaaaaaaaaaaaaaaaaaaaaaaaaaaaaaaaaaaaaaaaaaaaaaaaaaaaaaaaaaaaaaaaaaaaaaaaaaaaaaaaaaaaaaaaaaaaaaa
aaaaaaaaaaaaaaaaaaaaaaaaaaaaaaaaaaaaaaaaaaaaaaaaaaaaaaaaaaaaaaaaaaaaaaaaaaaaaaaaaaaaaaaaaaaaaaaaaaaa
aaaaaaaaaaaaaaaaaaaaaaaaaaaaaaaaaaaaaaaaaaaaaaaaaaaaaaaaaaaaaaaaaaaaaaaaaaaaaaaaaaaaaaaaaaaaaaaaaaaa
aaaaaaaaaaaaaaaaaaaaaaaaaaaaaaaaaaaaaaaaaaabacacacabacacacabaaaaaaaaaaaaaaaaaaaaaaaaaaaaaaaaaaaaaaaa
aaaaaaaaaaaaaaaaaaaaaaaaaaaaaaaaaaaaaaaaaaabadadadabadadadabaaaaaaaaaaaaaaaaaaaaaaaaaaaaaaaaaaaaaaaa
aaaaaaaaaaaaaaaaaaaaaaaaaaaaaaaaaaaaaaaaaaabadadadabadadadabaaaaaaaaaaaaaaaaaaaaaaaaaaaaaaaaaaaaaaaa
aaaaaaaaaaaaaaaaaaaaaaaaaaaaaaaaaaaaaaaaaaabadadadabadadadabaaaaaaaaaaaaaaaaaaaaaaaaaaaaaaaaaaaaaaaa
aaaaaaaaaaaaaaaaaaaaaaaaaaaaaaaaaaaaaaaaababadadadabadadadababaaaaaaaaaaaaaaaaaaaaaaaaaaaaaaaaaaaaaa
aaaaaaaaaaaaaaaaaaaaaaaaaaaaabaeafafafagababadadadabadadadababaeafafafagabaaaaaaaaaaaaaaaaaaaaaaaaaa
aaaaaaaaaaaaaaaaaaaaaaaaaaaaabahahahahahabababaiabababajabababahahahahahabaaaaaaaaaaaaaaaaaaaaaaaaaa
aaaaaaaaaaaaaaaaaaaaaaaaaaaaabakalalalalabamanaoanananapanamabalalalalaqabaaaaaaaaaaaaaaaaaaaaaaaaaa
aaaaaaaaaaaaaaaaaaaaaaaaaaaaabaradadadadasanatauavatawauatanasadadadadaxabaaaaaaaaaaaaaaaaaaaaaaaaaa
aaaaaaaaaaaaaaaaaaaaaaaaaaaaabayadadadadabanatauavatawauatanabazadadadaAabaaaaaaaaaaaaaaaaaaaaaaaaaa
aaaaaaaaaaaaaaaaaaaaaaaaaaaaaBababababababanatauavatawauatanababababababaBaaaaaaaaaaaaaaaaaaaaaaaaaa
aaaaaaaaaaaaaaaaaaaaaaaaaaaaaCadadadadadabanatauavatawauatanabadadadadadaCaaaaaaaaaaaaaaaaaaaaaaaaaa
aaaaaaaaaaaaaaaaaaaaaaaaaaaaaCadadadadadaDaEatatatatatatataFaGadadadadadaCaaaaaaaaaaaaaaaaaaaaaaaaaa
aaaaaaaaaaaaaaaaaaaaaaaaaaaaaCadadadadadabananananatananananabadadadadadaCaaaaaaaaaaaaaaaaaaaaaaaaaa
aaaaaaaaaaaaaaaaaaaaaHabababababababababababababanatanabababababababababababababaHaaaaaaaaaaaaaaaaaa
aaaaaaaaaaaaaaaaaaaaaCaIadaIaJaKaLaMaNaOaNaNaNabaOaPaOabadadadadadadadadadadadadaCaaaaaaaaaaaaaaaaaa
aaaaaaaaaaaaaaaaaaaaaCadadadaOaQaQaQaQaOaQaQaQabanatanabadadadadadadadadadadadadaCaaaaaaaaaaaaaaaaaa
aaaaaaaaaaaaaaaaaaaaaCaIadadaRaQaQaQaQaSaQaQaQabanatanabadadadadadadadadadadadadaCaaaaaaaaaaaaaaaaaa
aaaaaaaaaaaaaaaaaaaaaCadadadaOaTaQaQaTaOaQaQaQabanatanabadadadadadadadadadadadadaCaaaaaaaaaaaaaaaaaa
aaaaaaaaaaaaaaaaaaaaaCaIadaIaJaUaQaQaVaOaNaNaNabanatanabadadadadadadadadadadadadaCaaaaaaaaaaaaaaaaaa
aaaaaaaaaaaaaaaaaaaHaBababaOababaSaSabababaOababanatanababaOabababaWaWababaOabaBaHaaaaaaaaaaaaaaaaaa
aaaaaaaaaaaaaaaaaaabaXataOananananananananamaOananatananaOamanananaYananananaZaOaaaaaaaaaaaaaaaaaaaa
aaaaaaaaaaaaaaaaaabaaXatbaatatatatatatatatataPatatatatataPatatatatatatatatataZaOaaaaaaaaaaaaaaaaaaaa
aaaaaaaaaaaaaaaaaaabaXataOananananananananamaOananatananaOamanananbbananananaZaOaaaaaaaaaaaaaaaaaaaa
aaaaaaaaaaaaaaaaaaaHaBababaOababaJaJabababaJababanatanababaOabababbcbcababaOabaBaHaaaaaaaaaaaaaaaaaa
aaaaaaaaaaaaaaaaaaaaaCadadadadadadadabbdbeaJbfabanatanabadadadadadadadadadadadadaCaaaaaaaaaaaaaaaaaa
aaaaaaaaaaaaaaaaaaaaaCadadadadadadadabbgbhaJbiabanatanabadadadadadadadadadadadadaCaaaaaaaaaaaaaaaaaa
aaaaaaaaaaaaaaaaaaaaaCadadadadadadadabatatatatabanatanabadadadadadadadadadadadadaCaaaaaaaaaaaaaaaaaa
aaaaaaaaaaaaaaaaaaaaaCadadadadadadadbjbkatatatblanatanabadadadadadadadadadadadadaCaaaaaaaaaaaaaaaaaa
aaaaaaaaaaaaaaaaaaaaaCadadadadadadadbjatatatatblanatanabadadadadadadadadadadadadaCaaaaaaaaaaaaaaaaaa
aaaaaaaaaaaaaaaaaaaaaCadadadadadadadabaJaJbmaJabanatanabaJaJaJaJaJaJaJaJaJaJaJaJaJaaaaaaaaaaaaaaaaaa
aaaaaaaaaaaaaaaaaaaaaCadadadadadadadabbnbobobpabanatanbqatatatatatatatatatatatataJaaaaaaaaaaaaaaaaaa
aaaaaaaaaaaaaaaaaaaaaCadadadadadadadabbnbrbobpabaOaPaOabbsaubsaubsaubsaubsaubsauaJaaaaaaaaaaaaaaaaaa
aaaaaaaaaaaaaaaaaaaaaHababababababababababaJababanatanabababababababababababababaHaaaaaaaaaaaaaaaaaa
aaaaaaaaaaaaaaaaaaaaaaaaaaaaaCadadadadadabamanananatanananamabadadadadadaCaaaaaaaaaaaaaaaaaaaaaaaaaa
aaaaaaaaaaaaaaaaaaaaaaaaaaaaaCadadadadadbtbuatatatatatatatbvbwadadadadadaCaaaaaaaaaaaaaaaaaaaaaaaaaa
aaaaaaaaaaaaaaaaaaaaaaaaaaaaaCadadadadadabanatbxbxbxbxbxatanabadadadadadaCaaaaaaaaaaaaaaaaaaaaaaaaaa
aaaaaaaaaaaaaaaaaaaaaaaaaaaaabababababababanatbybybybybyatanabababababababaaaaaaaaaaaaaaaaaaaaaaaaaa
aaaaaaaaaaaaaaaaaaaaaaaaaaaaaCadadadadadabanatbybybybybyatanabadadadadadaCaaaaaaaaaaaaaaaaaaaaaaaaaa
aaaaaaaaaaaaaaaaaaaaaaaaaaaaaCadadadadadbzbAatbBbBbBbBbBatbCbDadadadadadaCaaaaaaaaaaaaaaaaaaaaaaaaaa
aaaaaaaaaaaaaaaaaaaaaaaaaaaaaCadadadadadabanatatatatatatatanabadadadadadaCaaaaaaaaaaaaaaaaaaaaaaaaaa
aaaaaaaaaaaaaaaaaaaaaaaaaaaaabababababababbEbFananatananbGbHabababababababaaaaaaaaaaaaaaaaaaaaaaaaaa
aaaaaaaaaaaaaaaaaaaaaaaaaaaaaaabbIbobJbKababababanatanababababbLbMbMbNabaaaaaaaaaaaaaaaaaaaaaaaaaaaa
aaaaaaaaaaaaaaaaaaaaaaaaaaaaaaabbObobobobPbPaOamanatanamaObQbRbSbTbTbUabaaaaaaaaaaaaaaaaaaaaaaaaaaaa
aaaaaaaaaaaaaaaaaaaaaaaaaaaaaaaObobobobobobobVanatatatanbVboboboboboboaOaaaaaaaaaaaaaaaaaaaaaaaaaaaa
aaaaaaaaaaaaaaaaaaaaaaaaaaaaaaabbWbobobXbYboaOanatatatanaOboboboboboboabaaaaaaaaaaaaaaaaaaaaaaaaaaaa
aaaaaaaaaaaaaaaaaaaaaaaaaaaaaaaHbZbobobQboboababaOcaaOababcbccbocdcecfaHaaaaaaaaaaaaaaaaaaaaaaaaaaaa
aaaaaaaaaaaaaaaaaaaaaaaaaaaaaaaHcgbobobXbYboabchcicjckclabaJaJcmaJaJaJaHaaaaaaaaaaaaaaaaaaaaaaaaaaaa
aaaaaaaaaaaaaaaaaaaaaaaaaaaaaaabcnboboboboboabcjcocjcocjabcpbobobocqaJabaaaaaaaaaaaaaaaaaaaaaaaaaaaa
aaaaaaaaaaaaaaaaaaaaaaaaaaaaaaababcrcsctcucvabcwcxcyczcAabcpbobobocqababaaaaaaaaaaaaaaaaaaaaaaaaaaaa
aaaaaaaaaaaaaaaaaaaaaaaaaaaaaaaaabababababababcBcBcBcBcBabababababababaaaaaaaaaaaaaaaaaaaaaaaaaaaaaa
aaaaaaaaaaaaaaaaaaaaaaaaaaaaaaaaaaaaaaaaaaaaaaaaaaaaaaaaaaaaaaaaaaaaaaaaaaaaaaaaaaaaaaaaaaaaaaaaaaaa
aaaaaaaaaaaaaaaaaaaaaaaaaaaaaaaaaaaaaaaaaaaaaaaaaaaaaaaaaaaaaaaaaaaaaaaaaaaaaaaaaaaaaaaaaaaaaaaaaaaa
aaaaaaaaaaaaaaaaaaaaaaaaaaaaaaaaaaaaaaaaaaaaaaaaaaaaaaaaaaaaaaaaaaaaaaaaaaaaaaaaaaaaaaaaaaaaaaaaaaaa
aaaaaaaaaaaaaaaaaaaaaaaaaaaaaaaaaaaaaaaaaaaaaaaaaaaaaaaaaaaaaaaaaaaaaaaaaaaaaaaaaaaaaaaaaaaaaaaaaaaa
aaaaaaaaaaaaaaaaaaaaaaaaaaaaaaaaaaaaaaaaaaaaaaaaaaaaaaaaaaaaaaaaaaaaaaaaaaaaaaaaaaaaaaaaaaaaaaaaaaaa
aaaaaaaaaaaaaaaaaaaaaaaaaaaaaaaaaaaaaaaaaaaaaaaaaaaaaaaaaaaaaaaaaaaaaaaaaaaaaaaaaaaaaaaaaaaaaaaaaaaa
aaaaaaaaaaaaaaaaaaaaaaaaaaaaaaaaaaaaaaaaaaaaaaaaaaaaaaaaaaaaaaaaaaaaaaaaaaaaaaaaaaaaaaaaaaaaaaaaaaaa
aaaaaaaaaaaaaaaaaaaaaaaaaaaaaaaaaaaaaaaaaaaaaaaaaaaaaaaaaaaaaaaaaaaaaaaaaaaaaaaaaaaaaaaaaaaaaaaaaaaa
aaaaaaaaaaaaaaaaaaaaaaaaaaaaaaaaaaaaaaaaaaaaaaaaaaaaaaaaaaaaaaaaaaaaaaaaaaaaaaaaaaaaaaaaaaaaaaaaaaaa
aaaaaaaaaaaaaaaaaaaaaaaaaaaaaaaaaaaaaaaaaaaaaaaaaaaaaaaaaaaaaaaaaaaaaaaaaaaaaaaaaaaaaaaaaaaaaaaaaaaa
aaaaaaaaaaaaaaaaaaaaaaaaaaaaaaaaaaaaaaaaaaaaaaaaaaaaaaaaaaaaaaaaaaaaaaaaaaaaaaaaaaaaaaaaaaaaaaaaaaaa
"}
