"a" = (/turf/template_noop,/area/template_noop)
"b" = (/turf/simulated/mineral/floor/ignore_mapgen/vacuum,/area/submap/buried_stash3)
"c" = (/obj/structure/closet/grave,/obj/random/drinkbottle,/obj/random/contraband,/obj/random/ammo,/obj/random/ammo,/obj/random/tool/power,/obj/random/unidentified_medicine/fresh_medicine,/obj/random/unidentified_medicine/combat_medicine,/obj/random/medical/pillbottle,/obj/random/projectile/sec,/turf/simulated/mineral/floor/ignore_mapgen/vacuum,/area/submap/buried_stash3)
"d" = (/mob/living/simple_mob/animal/space/bats,/turf/simulated/mineral/floor/ignore_mapgen/vacuum,/area/submap/buried_stash3)

(1,1,1) = {"
aaaaa
abbda
abcba
abbba
aaaaa
"}
