"aa" = (/turf/space,/area/space)
"ab" = (/turf/unsimulated/mineral{nitrogen = 0; oxygen = 0},/area/space)
"ak" = (/turf/simulated/wall/r_wall,/area/space)
"al" = (/obj/effect/floor_decal/borderfloorblack{dir = 8},/obj/effect/floor_decal/corner/green/border{dir = 8},/turf/simulated/floor/tiled,/area/space)
"am" = (/turf/simulated/floor/tiled,/area/space)
"an" = (/obj/machinery/atmospherics/pipe/simple/hidden/scrubbers,/obj/machinery/atmospherics/pipe/simple/hidden/supply,/obj/structure/cable{d1 = 1; d2 = 2; icon_state = "1-2"},/turf/simulated/floor/tiled,/area/space)
"ao" = (/obj/effect/floor_decal/borderfloorblack{dir = 4},/obj/effect/floor_decal/corner/green/border{dir = 4},/turf/simulated/floor/tiled,/area/space)
"ap" = (/obj/effect/floor_decal/borderfloorblack{dir = 10},/obj/effect/floor_decal/corner/green/border{dir = 10},/obj/machinery/light,/turf/simulated/floor/tiled,/area/space)
"aq" = (/obj/effect/floor_decal/borderfloorblack,/obj/effect/floor_decal/industrial/danger,/turf/simulated/floor/tiled,/area/space)
"ar" = (/obj/effect/floor_decal/borderfloorblack,/obj/effect/floor_decal/industrial/danger,/obj/machinery/atmospherics/pipe/simple/hidden/scrubbers,/obj/machinery/atmospherics/pipe/simple/hidden/supply,/obj/structure/cable{d1 = 1; d2 = 2; icon_state = "1-2"},/turf/simulated/floor/tiled,/area/space)
"as" = (/obj/effect/floor_decal/borderfloorblack{dir = 6},/obj/effect/floor_decal/corner/green/border{dir = 6},/obj/machinery/light,/turf/simulated/floor/tiled,/area/space)
"at" = (/obj/effect/floor_decal/borderfloorblack{dir = 9},/obj/machinery/light{icon_state = "tube1"; dir = 8},/turf/simulated/floor/tiled,/area/space)
"au" = (/obj/effect/floor_decal/borderfloorblack{dir = 1},/turf/simulated/floor/tiled,/area/space)
"av" = (/obj/effect/floor_decal/borderfloorblack{dir = 1},/obj/machinery/alarm{frequency = 1441; pixel_y = 22},/turf/simulated/floor/tiled,/area/space)
"aw" = (/obj/effect/floor_decal/borderfloorblack{dir = 1},/obj/structure/cable{d2 = 2; icon_state = "0-2"; pixel_y = 0},/obj/machinery/power/apc{dir = 1; name = "north bump"; pixel_x = 0; pixel_y = 24},/turf/simulated/floor/tiled,/area/space)
"ax" = (/obj/effect/floor_decal/borderfloorblack{dir = 1},/obj/machinery/firealarm{dir = 2; layer = 3.3; pixel_x = 0; pixel_y = 26},/turf/simulated/floor/tiled,/area/space)
"ay" = (/obj/effect/floor_decal/borderfloorblack{dir = 5},/obj/machinery/light{dir = 4; icon_state = "tube1"; pixel_x = 0},/turf/simulated/floor/tiled,/area/space)
"az" = (/turf/simulated/wall,/area/space)
"aA" = (/obj/machinery/door/firedoor/multi_tile,/obj/machinery/door/airlock/multi_tile/glass{name = "Facility Access"},/turf/simulated/floor/tiled/steel_grid,/area/space)
"aB" = (/obj/machinery/atmospherics/pipe/simple/hidden/scrubbers,/obj/machinery/atmospherics/pipe/simple/hidden/supply,/obj/structure/cable{d1 = 1; d2 = 2; icon_state = "1-2"},/turf/simulated/floor/tiled/steel_grid,/area/space)
"aC" = (/obj/machinery/door/firedoor/border_only,/obj/effect/wingrille_spawn/reinforced,/obj/structure/window/reinforced/full,/turf/simulated/floor/plating,/area/space)
"aD" = (/obj/effect/floor_decal/borderfloorblack{dir = 9},/turf/simulated/floor/tiled,/area/space)
"aE" = (/obj/effect/floor_decal/borderfloorblack/corner{dir = 1},/turf/simulated/floor/tiled,/area/space)
"aF" = (/obj/effect/floor_decal/industrial/outline/yellow,/turf/simulated/floor/tiled,/area/space)
"aG" = (/obj/effect/floor_decal/industrial/outline/yellow,/obj/structure/cable{d1 = 1; d2 = 2; icon_state = "1-2"},/turf/simulated/floor/tiled,/area/space)
"aH" = (/obj/effect/floor_decal/borderfloorblack/corner{dir = 4},/turf/simulated/floor/tiled,/area/space)
"aI" = (/obj/effect/floor_decal/borderfloorblack{dir = 5},/turf/simulated/floor/tiled,/area/space)
"aJ" = (/obj/effect/floor_decal/borderfloorblack{dir = 9},/obj/effect/floor_decal/corner/green/border{dir = 9},/obj/machinery/alarm{frequency = 1441; pixel_y = 22},/obj/machinery/light{icon_state = "tube1"; dir = 8},/turf/simulated/floor/tiled,/area/space)
"aK" = (/obj/effect/floor_decal/borderfloorblack{dir = 1},/obj/effect/floor_decal/corner/green/border{dir = 1},/turf/simulated/floor/tiled,/area/space)
"aL" = (/obj/effect/floor_decal/borderfloorblack{dir = 1},/obj/effect/floor_decal/industrial/danger{dir = 1},/turf/simulated/floor/tiled,/area/space)
"aM" = (/obj/effect/floor_decal/borderfloorblack{dir = 1},/obj/machinery/atmospherics/pipe/simple/hidden/scrubbers,/obj/machinery/atmospherics/pipe/simple/hidden/supply,/obj/structure/cable{d1 = 1; d2 = 2; icon_state = "1-2"},/obj/effect/floor_decal/industrial/danger{dir = 1},/turf/simulated/floor/tiled,/area/space)
"aN" = (/obj/effect/floor_decal/borderfloorblack{dir = 5},/obj/effect/floor_decal/corner/green/border{dir = 5},/obj/structure/cable{d2 = 2; icon_state = "0-2"; pixel_y = 0},/obj/machinery/power/apc{dir = 1; name = "north bump"; pixel_x = 0; pixel_y = 24},/obj/machinery/light{dir = 4; icon_state = "tube1"; pixel_x = 0},/turf/simulated/floor/tiled,/area/space)
"aO" = (/obj/effect/floor_decal/borderfloorblack{dir = 8},/turf/simulated/floor/tiled,/area/space)
"aP" = (/obj/effect/floor_decal/industrial/outline/yellow,/obj/machinery/atmospherics/unary/vent_scrubber/on{dir = 4},/turf/simulated/floor/tiled,/area/space)
"aQ" = (/obj/effect/floor_decal/industrial/outline/yellow,/obj/machinery/atmospherics/pipe/simple/hidden/scrubbers{dir = 4},/obj/machinery/atmospherics/pipe/simple/hidden/supply{dir = 6},/obj/structure/cable{d1 = 1; d2 = 4; icon_state = "1-4"},/turf/simulated/floor/tiled,/area/space)
"aR" = (/obj/effect/floor_decal/industrial/outline/yellow,/obj/machinery/atmospherics/pipe/simple/hidden/scrubbers{dir = 4},/obj/machinery/atmospherics/pipe/simple/hidden/supply{dir = 4},/obj/structure/cable{d1 = 4; d2 = 8; icon_state = "4-8"; pixel_x = 0},/turf/simulated/floor/tiled,/area/space)
"aS" = (/obj/machinery/atmospherics/pipe/simple/hidden/scrubbers{dir = 4},/obj/machinery/atmospherics/pipe/simple/hidden/supply{dir = 4},/obj/structure/cable{d1 = 4; d2 = 8; icon_state = "4-8"; pixel_x = 0},/turf/simulated/floor/tiled,/area/space)
"aT" = (/obj/effect/floor_decal/borderfloorblack{dir = 4},/obj/machinery/atmospherics/pipe/simple/hidden/scrubbers{dir = 4},/obj/machinery/atmospherics/pipe/simple/hidden/supply{dir = 4},/obj/structure/cable{d1 = 4; d2 = 8; icon_state = "4-8"; pixel_x = 0},/obj/effect/floor_decal/industrial/danger{dir = 4},/turf/simulated/floor/tiled,/area/space)
"aU" = (/obj/machinery/atmospherics/pipe/simple/hidden/scrubbers{dir = 4},/obj/machinery/atmospherics/pipe/simple/hidden/supply{dir = 4},/obj/structure/cable{d1 = 4; d2 = 8; icon_state = "4-8"; pixel_x = 0},/turf/simulated/floor/tiled/steel_grid,/area/space)
"aV" = (/obj/effect/floor_decal/borderfloorblack{dir = 8},/obj/machinery/atmospherics/pipe/simple/hidden/scrubbers{dir = 4},/obj/machinery/atmospherics/pipe/simple/hidden/supply{dir = 4},/obj/structure/cable{d1 = 4; d2 = 8; icon_state = "4-8"; pixel_x = 0},/obj/effect/floor_decal/industrial/danger{dir = 8},/turf/simulated/floor/tiled,/area/space)
"aW" = (/obj/machinery/atmospherics/pipe/manifold4w/hidden/scrubbers,/obj/machinery/atmospherics/pipe/manifold4w/hidden/supply,/obj/structure/cable{d1 = 1; d2 = 2; icon_state = "1-2"},/obj/structure/cable{d1 = 1; d2 = 4; icon_state = "1-4"},/obj/structure/cable{d1 = 1; d2 = 8; icon_state = "1-8"},/turf/simulated/floor/tiled,/area/space)
"aX" = (/obj/effect/floor_decal/borderfloorblack{dir = 4},/obj/machinery/atmospherics/pipe/simple/hidden/scrubbers{dir = 4},/obj/machinery/atmospherics/pipe/simple/hidden/supply{dir = 4},/obj/structure/cable{d1 = 4; d2 = 8; icon_state = "4-8"; pixel_x = 0},/obj/effect/floor_decal/industrial/danger{dir = 4},/obj/structure/cable{d1 = 1; d2 = 8; icon_state = "1-8"},/turf/simulated/floor/tiled,/area/space)
"aY" = (/obj/effect/floor_decal/industrial/outline/yellow,/obj/machinery/atmospherics/pipe/simple/hidden/scrubbers{dir = 4},/obj/machinery/atmospherics/pipe/simple/hidden/supply{dir = 10},/obj/structure/cable{d1 = 1; d2 = 8; icon_state = "1-8"},/turf/simulated/floor/tiled,/area/space)
"aZ" = (/obj/effect/floor_decal/industrial/outline/yellow,/obj/machinery/atmospherics/unary/vent_scrubber/on{dir = 8},/turf/simulated/floor/tiled,/area/space)
"ba" = (/obj/effect/floor_decal/borderfloorblack{dir = 4},/turf/simulated/floor/tiled,/area/space)
"bb" = (/obj/effect/floor_decal/industrial/outline/yellow,/obj/machinery/atmospherics/unary/vent_pump/on{dir = 4},/turf/simulated/floor/tiled,/area/space)
"bc" = (/obj/effect/floor_decal/industrial/outline/yellow,/obj/machinery/atmospherics/pipe/simple/hidden/supply{dir = 9; pixel_y = 0},/turf/simulated/floor/tiled,/area/space)
"bd" = (/obj/effect/floor_decal/borderfloorblack{dir = 4},/obj/effect/floor_decal/industrial/danger{dir = 4},/turf/simulated/floor/tiled,/area/space)
"be" = (/obj/machinery/door/firedoor/multi_tile{dir = 2},/obj/machinery/door/airlock/multi_tile/glass{dir = 2; name = "Storage Alpha"},/turf/simulated/floor/tiled/steel_grid,/area/space)
"bf" = (/obj/effect/floor_decal/borderfloorblack{dir = 8},/obj/effect/floor_decal/industrial/danger{dir = 8},/turf/simulated/floor/tiled,/area/space)
"bg" = (/obj/machinery/atmospherics/unary/vent_pump/on{dir = 4},/turf/simulated/floor/tiled,/area/space)
"bh" = (/obj/machinery/atmospherics/pipe/simple/hidden/supply{dir = 9; pixel_y = 0},/obj/machinery/atmospherics/pipe/simple/hidden/scrubbers{dir = 5},/obj/structure/cable{d1 = 1; d2 = 2; icon_state = "1-2"},/turf/simulated/floor/tiled,/area/space)
"bi" = (/obj/machinery/atmospherics/unary/vent_scrubber/on{dir = 8},/turf/simulated/floor/tiled,/area/space)
"bj" = (/obj/machinery/door/firedoor/multi_tile{dir = 2},/obj/machinery/door/airlock/multi_tile/glass{dir = 2; name = "Storage Beta"},/turf/simulated/floor/tiled/steel_grid,/area/space)
"bk" = (/obj/effect/floor_decal/industrial/outline/yellow,/obj/machinery/atmospherics/pipe/simple/hidden/supply{dir = 5},/turf/simulated/floor/tiled,/area/space)
"bl" = (/obj/effect/floor_decal/industrial/outline/yellow,/obj/machinery/atmospherics/unary/vent_pump/on{dir = 8},/turf/simulated/floor/tiled,/area/space)
"bm" = (/obj/effect/floor_decal/borderfloorblack{dir = 10},/turf/simulated/floor/tiled,/area/space)
"bn" = (/obj/effect/floor_decal/borderfloorblack/corner{dir = 8},/turf/simulated/floor/tiled,/area/space)
"bo" = (/obj/effect/floor_decal/borderfloorblack/corner,/turf/simulated/floor/tiled,/area/space)
"bp" = (/obj/effect/floor_decal/borderfloorblack{dir = 6},/turf/simulated/floor/tiled,/area/space)
"bq" = (/obj/effect/floor_decal/borderfloorblack{dir = 10},/obj/effect/floor_decal/corner/green/border{dir = 10},/obj/machinery/light{icon_state = "tube1"; dir = 8},/turf/simulated/floor/tiled,/area/space)
"br" = (/obj/effect/floor_decal/borderfloorblack,/obj/effect/floor_decal/corner/green/border,/turf/simulated/floor/tiled,/area/space)
"bs" = (/obj/effect/floor_decal/borderfloorblack,/obj/structure/cable{d1 = 1; d2 = 2; icon_state = "1-2"},/obj/effect/floor_decal/industrial/danger,/turf/simulated/floor/tiled,/area/space)
"bt" = (/obj/effect/floor_decal/borderfloorblack{dir = 6},/obj/effect/floor_decal/corner/green/border{dir = 6},/obj/machinery/firealarm{dir = 1; pixel_x = 0; pixel_y = -24},/obj/machinery/light{dir = 4; icon_state = "tube1"; pixel_x = 0},/turf/simulated/floor/tiled,/area/space)
"bu" = (/obj/effect/floor_decal/borderfloorblack{dir = 10},/obj/machinery/light{icon_state = "tube1"; dir = 8},/turf/simulated/floor/tiled,/area/space)
"bv" = (/obj/effect/floor_decal/borderfloorblack,/turf/simulated/floor/tiled,/area/space)
"bw" = (/obj/effect/floor_decal/borderfloorblack{dir = 6},/obj/machinery/light{dir = 4; icon_state = "tube1"; pixel_x = 0},/turf/simulated/floor/tiled,/area/space)
"bx" = (/obj/machinery/door/airlock/external,/turf/simulated/floor/tiled/steel_grid,/area/space)
"by" = (/obj/machinery/door/airlock/external,/obj/structure/cable{d1 = 1; d2 = 2; icon_state = "1-2"},/turf/simulated/floor/tiled/steel_grid,/area/space)
"bz" = (/obj/effect/floor_decal/borderfloorblack{dir = 9},/obj/effect/floor_decal/industrial/danger{dir = 9},/obj/machinery/light/small{brightness_color = "#DA0205"; brightness_power = 1; brightness_range = 5; dir = 8},/turf/simulated/floor/tiled/steel_grid,/area/space)
"bA" = (/obj/effect/floor_decal/borderfloorblack{dir = 1},/obj/effect/floor_decal/industrial/danger{dir = 1},/turf/simulated/floor/tiled/steel_grid,/area/space)
"bB" = (/obj/effect/floor_decal/borderfloorblack{dir = 1},/obj/effect/floor_decal/industrial/danger{dir = 1},/obj/structure/cable{d1 = 1; d2 = 4; icon_state = "1-4"},/turf/simulated/floor/tiled/steel_grid,/area/space)
"bC" = (/obj/effect/floor_decal/borderfloorblack{dir = 5},/obj/effect/floor_decal/industrial/danger{dir = 5},/obj/structure/cable{d2 = 8; icon_state = "0-8"},/obj/machinery/power/apc{dir = 4; name = "east bump"; pixel_x = 24},/turf/simulated/floor/tiled/steel_grid,/area/space)
"bD" = (/obj/effect/floor_decal/borderfloorblack{dir = 8},/obj/effect/floor_decal/industrial/danger{dir = 8},/turf/simulated/floor/tiled/steel_grid,/area/space)
"bE" = (/turf/simulated/floor/tiled/steel_grid,/area/space)
"bF" = (/obj/effect/floor_decal/borderfloorblack{dir = 4},/obj/effect/floor_decal/industrial/danger{dir = 4},/turf/simulated/floor/tiled/steel_grid,/area/space)
"bG" = (/obj/effect/floor_decal/borderfloorblack/corner,/obj/effect/floor_decal/industrial/danger/corner,/turf/simulated/floor/tiled/steel_grid/airless,/area/space)
"bH" = (/obj/effect/floor_decal/borderfloorblack/corner{dir = 8},/obj/effect/floor_decal/industrial/danger/corner{dir = 1},/turf/simulated/floor/tiled/steel_grid/airless,/area/space)
"bI" = (/obj/effect/floor_decal/borderfloorblack{dir = 4},/obj/effect/floor_decal/industrial/danger{dir = 4},/turf/simulated/floor/tiled/steel_grid/airless,/area/space)
"bJ" = (/obj/effect/floor_decal/borderfloorblack{dir = 10},/obj/effect/floor_decal/industrial/danger{dir = 10},/obj/machinery/light/small{brightness_color = "#DA0205"; brightness_power = 1; brightness_range = 5; dir = 8},/turf/simulated/floor/tiled/steel_grid,/area/space)
"bK" = (/obj/effect/floor_decal/borderfloorblack,/obj/effect/floor_decal/industrial/danger,/turf/simulated/floor/tiled/steel_grid,/area/space)
"bL" = (/obj/effect/floor_decal/borderfloorblack{dir = 6},/obj/effect/floor_decal/industrial/danger{dir = 6},/turf/simulated/floor/tiled/steel_grid,/area/space)
"bM" = (/obj/effect/floor_decal/borderfloorblack{dir = 8},/obj/effect/floor_decal/industrial/danger{dir = 8},/turf/simulated/floor/tiled/steel_grid/airless,/area/space)
"bN" = (/obj/effect/floor_decal/borderfloorblack/corner{dir = 4},/obj/effect/floor_decal/industrial/danger/corner{dir = 4},/turf/simulated/floor/tiled/steel_grid/airless,/area/space)
"bO" = (/obj/effect/floor_decal/borderfloorblack{dir = 1},/obj/effect/floor_decal/industrial/danger{dir = 1},/obj/machinery/light/small{dir = 1},/turf/simulated/floor/tiled/steel_grid/airless,/area/space)
"bP" = (/obj/effect/floor_decal/borderfloorblack{dir = 1},/obj/effect/floor_decal/industrial/danger{dir = 1},/turf/simulated/floor/tiled/steel_grid/airless,/area/space)
"bQ" = (/obj/effect/floor_decal/borderfloorblack/corner{dir = 1},/obj/effect/floor_decal/industrial/danger/corner{dir = 8},/turf/simulated/floor/tiled/steel_grid/airless,/area/space)
"bR" = (/turf/simulated/floor/tiled/steel_grid/airless,/area/space)

(1,1,1) = {"
aaabababababababababababaaaaaaaaaaaaabababababababababababaa
aaabababababababababababaaaaaaaaaaaaabababababababababababaa
aaaaaaaaaaaaaaaaaaaaaaaaakalamanaoakaaaaaaaaaaaaaaaaaaaaaaaa
aaaaaaaaaaaaaaaaaaaaaaaaakalamanaoakaaaaaaaaaaaaaaaaaaaaaaaa
aaaaakakakakakakakakakaaakapaqarasakaaakakakakakakakakakaaaa
aaakakatauavawaxauayakakakazaAaBazakakakatauavawaxauayakakaa
aaaCaDaEaFaFaGaFaFaHaIazaJaKaLaMaKaNazaDaEaFaFaGaFaFaHaIaCaa
aaaCaOamaFaPaQaRaRaSaTaUaVaSaSaWaSaXaUaVaSaRaRaYaZaFambaaCaa
aaaCaOamaFbbbcaFaFambdbebfambgbhbibdbjbfamaFaFbkblaFambaaCaa
aaaCbmbnaFaFaFaFaFbobpazbqbraqbsbrbtazbmbnaFaFaFaFaFbobpaCaa
aaakakbubvbvbvbvbvbwakakakaCbxbyaCakakakbubvbvbvbvbvbwakakaa
aaaaakaCaCaCaCaCaCaCakaaakbzbAbBbCakaaakaCaCaCaCaCaCaCakaaaa
aaaaaaaaaaaaaaaaaaaaaaaaaCbDbEbEbFaCaaaaaaaaaaaaaaaaaaaaaaaa
aaaaaaaaaaaaaaaaaaaaaaaaaCbDbEbEbFaCaaaaaaaaaaaaaaaaaaaaaaaa
aaaaaaaaaaaaaaaaaaaaaabGaCbDbEbEbFaCbHaaaaaaaaaaaaaaaaaaaaaa
aaaaaaaaaaaaaaaaaaaaaabIakbJbKbKbLakbMaaaaaaaaaaaaaaaaaaaaaa
aaaaaaaaaaaaaaaaaaaaaabIakaCbxbxaCakbMaaaaaaaaaaaaaaaaaaaaaa
aaaaaaaaaaaaaaaaaaaaaabNbObPbPbPbPbObQaaaaaaaaaaaaaaaaaaaaaa
aaaaaaaaaaaaaaaaaaaaaabRbRbRbRbRbRbRbRaaaaaaaaaaaaaaaaaaaaaa
aaaaaaaaaaaaaaaaaaaaaaaabRbRbRbRbRbRaaaaaaaaaaaaaaaaaaaaaaaa
"}
