"a" = (/turf/template_noop,/area/template_noop)
"b" = (/obj/structure/shuttle/engine/propulsion/burst{dir = 1},/turf/simulated/shuttle/wall,/area/submap/wreckage/escape_pods4)
"c" = (/obj/structure/door_assembly/door_assembly_ext,/turf/simulated/shuttle/floor,/area/submap/wreckage/escape_pods4)
"d" = (/turf/simulated/shuttle/wall,/area/submap/wreckage/escape_pods4)
"e" = (/obj/structure/bed/chair,/obj/item/radio/intercom{dir = 8; name = "Station Intercom (General)"; pixel_x = -28},/obj/structure/closet/walllocker/emerglocker{pixel_x = 28},/obj/item/weldingtool,/turf/simulated/shuttle/floor,/area/submap/wreckage/escape_pods4)
"f" = (/obj/structure/shuttle/engine/propulsion/burst{icon_state = "propulsion"; dir = 4},/turf/simulated/shuttle/wall,/area/submap/wreckage/escape_pods4)
"g" = (/obj/structure/bed/chair,/obj/machinery/vending/wallmed1{layer = 3.3; name = "Emergency NanoMed"; pixel_x = 28; pixel_y = 0},/obj/machinery/light{dir = 8; icon_state = "tube1"; pixel_y = 0},/turf/simulated/shuttle/floor,/area/submap/wreckage/escape_pods4)
"h" = (/obj/structure/shuttle/window,/obj/structure/grille,/turf/simulated/shuttle/plating,/area/submap/wreckage/escape_pods4)
"i" = (/obj/structure/bed/chair{icon_state = "chair_preview"; dir = 8},/obj/effect/decal/cleanable/dirt,/obj/machinery/status_display{pixel_y = -32},/turf/simulated/shuttle/floor,/area/submap/wreckage/escape_pods4)
"j" = (/obj/structure/bed/chair{icon_state = "chair_preview"; dir = 8},/obj/structure/loot_pile/surface/medicine_cabinet{pixel_y = 28},/obj/machinery/light,/obj/effect/decal/cleanable/blood/drip,/obj/effect/decal/cleanable/dirt,/obj/effect/decal/cleanable/blood/drip,/turf/simulated/shuttle/floor,/area/submap/wreckage/escape_pods4)
"k" = (/obj/structure/bed/chair{icon_state = "chair_preview"; dir = 8},/obj/structure/closet/walllocker/emerglocker{pixel_y = 28},/obj/effect/decal/cleanable/dirt,/obj/effect/decal/cleanable/blood/drip,/obj/item/airlock_electronics,/turf/simulated/shuttle/floor,/area/submap/wreckage/escape_pods4)
"l" = (/obj/effect/decal/cleanable/blood/drip,/obj/machinery/door/airlock/external{icon_state = "door_locked"; locked = 1; name = "Escape Pod Hatch"},/turf/simulated/shuttle/floor,/area/submap/wreckage/escape_pods4)
"m" = (/obj/structure/bed/chair,/obj/machinery/status_display{density = 0; layer = 4; pixel_x = -32; pixel_y = 0},/turf/simulated/shuttle/floor,/area/submap/wreckage/escape_pods4)
"n" = (/obj/structure/bed/chair,/obj/item/radio/intercom{dir = 8; name = "Station Intercom (General)"; pixel_x = -28},/obj/structure/closet/walllocker/emerglocker{pixel_x = 28},/turf/simulated/shuttle/floor,/area/submap/wreckage/escape_pods4)
"o" = (/turf/simulated/shuttle/wall{under_turf = "/turf/simulated/mineral/floor/ignore_mapgen/vacuum"},/area/submap/wreckage/escape_pods4)
"p" = (/obj/structure/bed/chair{icon_state = "chair_preview"; dir = 8},/obj/structure/loot_pile/surface/bones,/obj/effect/decal/cleanable/blood,/obj/effect/decal/cleanable/dirt,/obj/machinery/status_display{pixel_y = -32},/turf/simulated/shuttle/floor,/area/submap/wreckage/escape_pods4)
"q" = (/obj/structure/bed/chair{icon_state = "chair_preview"; dir = 8},/obj/structure/closet/walllocker/emerglocker{pixel_y = 28},/obj/effect/decal/cleanable/dirt,/obj/effect/decal/cleanable/blood/drip,/turf/simulated/shuttle/floor,/area/submap/wreckage/escape_pods4)
"r" = (/obj/structure/bed/chair{icon_state = "chair_preview"; dir = 8},/obj/structure/loot_pile/surface/medicine_cabinet{pixel_y = 28},/obj/machinery/light,/obj/effect/decal/cleanable/vomit,/obj/effect/decal/cleanable/blood/drip,/obj/effect/decal/cleanable/dirt,/obj/effect/decal/cleanable/blood/drip,/obj/item/reagent_containers/hypospray/autoinjector/empty,/turf/simulated/shuttle/floor,/area/submap/wreckage/escape_pods4)
"s" = (/obj/effect/decal/cleanable/blood/oil,/turf/template_noop,/area/template_noop)
"t" = (/turf/simulated/mineral/floor/ignore_mapgen/vacuum,/area/template_noop)
"u" = (/obj/effect/decal/cleanable/blood/oil,/turf/simulated/mineral/floor/ignore_mapgen/vacuum,/area/template_noop)
"v" = (/obj/effect/decal/cleanable/blood/oil,/obj/effect/decal/cleanable/blood/oil,/turf/simulated/mineral/floor/ignore_mapgen/vacuum,/area/template_noop)
"w" = (/turf/simulated/shuttle/wall{under_turf = "/turf/simulated/mineral/floor/ignore_mapgen/vacuum"},/area/submap/wreckage/escape_pods1)
"x" = (/obj/structure/shuttle/window,/turf/simulated/shuttle/plating,/area/submap/wreckage/escape_pods4)

(1,1,1) = {"
tttttasaaaaasaaaaass
tbcbttttttttsaassaaa
tdedttodddftttttasaa
tdgdtthijkctblbtuttt
tdmdttodddftdndtblbt
twhottttttttdgdtdndt
ttuttodddfttdmdtdgdt
aaaauxpjqlttohotdmdt
sasatodddfttttttohot
aaaattttttttttattttt
tuttttttodddftsaaaas
todddfvtxirqltsasaaa
txijqlutodddftaaaasa
uodddfttttttutaasaaa
tttttttaasaasaaaaaaa
"}
