"a" = (/turf/template_noop,/area/template_noop)
"b" = (/obj/structure/shuttle/engine/propulsion/burst{dir = 1},/turf/simulated/shuttle/wall,/area/submap/wreckage/escape_pods1)
"c" = (/obj/effect/decal/cleanable/blood/drip,/obj/machinery/door/airlock/external{icon_state = "door_locked"; locked = 1; name = "Escape Pod Hatch"},/turf/simulated/shuttle/floor,/area/submap/wreckage/escape_pods1)
"d" = (/obj/structure/door_assembly/door_assembly_ext,/turf/simulated/shuttle/floor,/area/submap/wreckage/escape_pods1)
"e" = (/turf/simulated/shuttle/wall,/area/submap/wreckage/escape_pods1)
"f" = (/turf/simulated/shuttle/wall{under_turf = "/turf/simulated/mineral/floor/ignore_mapgen/vacuum"},/area/submap/wreckage/escape_pods1)
"g" = (/obj/structure/bed/chair,/obj/item/radio/intercom{dir = 8; name = "Station Intercom (General)"; pixel_x = -28},/obj/structure/closet/walllocker/emerglocker{pixel_x = 28},/obj/item/weldingtool,/turf/simulated/shuttle/floor,/area/submap/wreckage/escape_pods1)
"h" = (/obj/structure/bed/chair,/obj/machinery/vending/wallmed1{layer = 3.3; name = "Emergency NanoMed"; pixel_x = 28; pixel_y = 0},/obj/machinery/light{dir = 8; icon_state = "tube1"; pixel_y = 0},/turf/simulated/shuttle/floor,/area/submap/wreckage/escape_pods1)
"i" = (/obj/structure/bed/chair,/obj/machinery/status_display{density = 0; layer = 4; pixel_x = -32; pixel_y = 0},/turf/simulated/shuttle/floor,/area/submap/wreckage/escape_pods1)
"j" = (/obj/structure/shuttle/window,/obj/structure/grille,/turf/simulated/shuttle/plating,/area/submap/wreckage/escape_pods1)
"k" = (/obj/item/airlock_electronics,/turf/simulated/shuttle/floor,/area/submap/wreckage/escape_pods1)
"l" = (/turf/simulated/mineral/floor/ignore_mapgen/vacuum,/area/template_noop)
"m" = (/obj/effect/decal/cleanable/blood/oil,/turf/template_noop,/area/template_noop)
"n" = (/obj/effect/decal/cleanable/blood/oil,/turf/simulated/mineral/floor/ignore_mapgen/vacuum,/area/template_noop)
"o" = (/obj/structure/door_assembly/door_assembly_ext,/turf/simulated/mineral/floor/ignore_mapgen/vacuum,/area/template_noop)

(1,1,1) = {"
lllllaaalllllaaaaaaa
lbcblnlllbdblamlllll
legelbcblegelaalbdbl
lehelegelehelmalegel
leieleheleielmalehel
lfjfleielfjflaaneiel
lllllfjfllllllllfjfl
amaalllllllbcbllllll
alllnllbcblegelbcbla
albkbllegelehelegela
aoegelleheleielehelm
alehelneielfjfleiela
mleiellfjflllllfjfla
alfjfllllnlaanllnlla
allllllaaaaaaaaamaaa
"}
