"a" = (/turf/template_noop,/area/template_noop)
"b" = (/turf/simulated/mineral/floor/vacuum,/area/submap/grease_pile5)
"c" = (/obj/effect/decal/cleanable/blood/oil/streak,/turf/simulated/mineral/floor/vacuum,/area/submap/grease_pile5)
"d" = (/obj/effect/decal/cleanable/blood/oil,/turf/simulated/mineral/floor/vacuum,/area/submap/grease_pile5)
"e" = (/obj/effect/decal/cleanable/blood/gibs/robot,/turf/simulated/mineral/floor/vacuum,/area/submap/grease_pile5)

(1,1,1) = {"
aaaaaaaaaa
abbbbbbcba
abbdbbbbba
abbbbbbdba
abebdbbbba
abbbbcbbba
adbdbbdeba
abbbbbbbba
abbbebbbca
aaaaaaaaaa
"}
