"a" = (/turf/template_noop,/area/template_noop)
"b" = (/turf/simulated/mineral/floor/vacuum,/area/submap/grease_pile2)
"c" = (/obj/effect/decal/cleanable/blood/oil,/turf/simulated/mineral/floor/vacuum,/area/submap/grease_pile2)
"d" = (/obj/effect/decal/cleanable/blood/gibs/robot,/turf/simulated/mineral/floor/vacuum,/area/submap/grease_pile2)
"e" = (/obj/structure/loot_pile/maint/technical,/turf/simulated/mineral/floor/vacuum,/area/submap/grease_pile2)

(1,1,1) = {"
aaaaaaaaaa
aeebbbbcba
aedcbcedba
abbdbbbbba
acbbbbbbba
abbccbcbba
abbecebbba
abbcecbbca
acbebbbeea
aaaaaaaaaa
"}
