"a" = (/turf/template_noop,/area/template_noop)
"b" = (/turf/simulated/mineral/floor/vacuum,/area/submap/grease_pile1)
"c" = (/obj/effect/decal/cleanable/blood/oil,/turf/simulated/mineral/floor/vacuum,/area/submap/grease_pile1)
"d" = (/obj/effect/decal/cleanable/blood/gibs/robot,/turf/simulated/mineral/floor/vacuum,/area/submap/grease_pile1)
"e" = (/obj/structure/loot_pile/maint/technical,/turf/simulated/mineral/floor/vacuum,/area/submap/grease_pile1)

(1,1,1) = {"
aaaaaaaaaa
abcbbbbbba
abbbcbbcba
abceebbeba
abbecbdbba
abbbbcbcba
abdbeebbba
acecbecbba
abbbbbbbba
aaaaaaaaaa
"}
