"a" = (/turf/template_noop,/area/template_noop)
"b" = (/turf/simulated/mineral/floor/vacuum,/area/submap/grease_pile4)
"c" = (/obj/effect/decal/cleanable/blood/oil,/turf/simulated/mineral/floor/vacuum,/area/submap/grease_pile4)
"d" = (/obj/effect/decal/cleanable/blood/gibs/robot,/turf/simulated/mineral/floor/vacuum,/area/submap/grease_pile4)

(1,1,1) = {"
aaaaaaaaaa
abbbbbbbba
abcbbbcdba
abbbbbbbba
abbbcbbcba
abdbbbbbca
acbbbcbbba
abbbbbbdba
abcbbbbbba
aaaaaaaaaa
"}
