"aa" = (/turf/template_noop,/area/template_noop)
"ab" = (/turf/simulated/mineral/floor/vacuum,/area/template_noop)
"ac" = (/turf/simulated/shuttle/wall/dark,/area/submap/shuttles/mercenary1)
"ad" = (/turf/simulated/shuttle/wall/dark/hard_corner,/area/submap/shuttles/mercenary1)
"ae" = (/obj/machinery/door/airlock/external{density = 1; frequency = 1331; id_tag = "merc_shuttle_outer"; name = "Ship External Access"; req_access = list(150)},/turf/simulated/floor/plating,/area/submap/shuttles/mercenary1)
"af" = (/obj/structure/shuttle/engine/heater{icon_state = "heater"; dir = 4},/turf/simulated/shuttle/wall/dark{icon_state = "dark0"; name = "Unknown Shuttle"},/area/submap/shuttles/mercenary1)
"ag" = (/obj/structure/shuttle/engine/propulsion{dir = 4; icon_state = "propulsion_l"},/turf/simulated/floor/plating,/area/submap/shuttles/mercenary1)
"ah" = (/obj/machinery/light{dir = 1},/obj/structure/table/rack,/obj/item/clothing/head/helmet/space,/obj/item/clothing/head/helmet/space,/obj/item/clothing/head/helmet/space,/obj/item/clothing/head/helmet/space,/obj/item/clothing/suit/space,/obj/item/clothing/suit/space,/obj/item/clothing/suit/space,/obj/item/clothing/suit/space,/obj/effect/floor_decal/borderfloor{dir = 9},/turf/simulated/floor/tiled/steel,/area/submap/shuttles/mercenary1)
"ai" = (/obj/structure/dispenser/oxygen,/obj/effect/floor_decal/borderfloor{dir = 5},/turf/simulated/floor/tiled/steel,/area/submap/shuttles/mercenary1)
"aj" = (/turf/simulated/floor/plating,/area/submap/shuttles/mercenary1)
"ak" = (/obj/effect/floor_decal/corner/green/border{icon_state = "bordercolor"; dir = 9},/turf/simulated/floor/tiled/white,/area/submap/shuttles/mercenary1)
"al" = (/obj/machinery/gibber,/obj/effect/floor_decal/corner/green/border{icon_state = "bordercolor"; dir = 1},/turf/simulated/floor/tiled/white,/area/submap/shuttles/mercenary1)
"am" = (/obj/machinery/light{dir = 1},/obj/effect/floor_decal/corner/green/border{icon_state = "bordercolor"; dir = 1},/turf/simulated/floor/tiled/white,/area/submap/shuttles/mercenary1)
"an" = (/obj/machinery/bodyscanner{dir = 8},/obj/effect/floor_decal/corner/green/border{icon_state = "bordercolor"; dir = 1},/turf/simulated/floor/tiled/white,/area/submap/shuttles/mercenary1)
"ao" = (/obj/machinery/body_scanconsole,/obj/effect/floor_decal/corner/green/border{icon_state = "bordercolor"; dir = 5},/turf/simulated/floor/tiled/white,/area/submap/shuttles/mercenary1)
"ap" = (/turf/simulated/floor/tiled/steel_grid,/area/submap/shuttles/mercenary1)
"aq" = (/obj/structure/table/steel,/obj/item/gun/projectile/automatic/wt550,/turf/simulated/floor/tiled/steel_grid,/area/submap/shuttles/mercenary1)
"ar" = (/obj/effect/floor_decal/borderfloor{dir = 8},/turf/simulated/floor/tiled/steel,/area/submap/shuttles/mercenary1)
"as" = (/obj/effect/floor_decal/borderfloor{dir = 4},/turf/simulated/floor/tiled/steel,/area/submap/shuttles/mercenary1)
"at" = (/obj/machinery/door/airlock/external,/turf/simulated/floor/plating,/area/submap/shuttles/mercenary1)
"au" = (/obj/effect/floor_decal/corner/green/border{icon_state = "bordercolor"; dir = 8},/turf/simulated/floor/tiled/white,/area/submap/shuttles/mercenary1)
"av" = (/obj/machinery/optable,/turf/simulated/floor/tiled/white,/area/submap/shuttles/mercenary1)
"aw" = (/obj/effect/decal/cleanable/blood,/turf/simulated/floor/tiled/white,/area/submap/shuttles/mercenary1)
"ax" = (/turf/simulated/floor/tiled/white,/area/submap/shuttles/mercenary1)
"ay" = (/mob/living/simple_mob/mechanical/viscerator,/turf/simulated/floor/tiled/white,/area/submap/shuttles/mercenary1)
"az" = (/obj/machinery/organ_printer/flesh,/obj/effect/floor_decal/corner/green/border{icon_state = "bordercolor"; dir = 5},/turf/simulated/floor/tiled/white,/area/submap/shuttles/mercenary1)
"aA" = (/mob/living/simple_mob/mechanical/viscerator,/mob/living/simple_mob/mechanical/viscerator,/mob/living/simple_mob/mechanical/viscerator,/turf/simulated/floor/tiled/steel_grid,/area/submap/shuttles/mercenary1)
"aB" = (/obj/structure/table/steel,/obj/machinery/light/small{dir = 4; pixel_y = 0},/turf/simulated/floor/tiled/steel_grid,/area/submap/shuttles/mercenary1)
"aC" = (/obj/effect/floor_decal/borderfloor/corner{dir = 4},/turf/simulated/floor/tiled/steel,/area/submap/shuttles/mercenary1)
"aD" = (/obj/effect/floor_decal/borderfloor{dir = 1},/turf/simulated/floor/tiled/steel,/area/submap/shuttles/mercenary1)
"aE" = (/obj/effect/floor_decal/borderfloor{dir = 5},/turf/simulated/floor/tiled/steel,/area/submap/shuttles/mercenary1)
"aF" = (/obj/effect/decal/cleanable/blood/drip,/turf/simulated/floor/tiled/white,/area/submap/shuttles/mercenary1)
"aG" = (/obj/structure/loot_pile/surface/bones,/turf/simulated/floor/tiled/white,/area/submap/shuttles/mercenary1)
"aH" = (/obj/machinery/light{dir = 4; icon_state = "tube1"; pixel_x = 0},/obj/effect/floor_decal/corner/green/border{icon_state = "bordercolor"; dir = 4},/turf/simulated/floor/tiled/white,/area/submap/shuttles/mercenary1)
"aI" = (/obj/structure/table/steel,/obj/effect/floor_decal/borderfloor/full,/turf/simulated/floor/tiled/steel,/area/submap/shuttles/mercenary1)
"aJ" = (/obj/structure/table/steel,/turf/simulated/floor/tiled/steel_grid,/area/submap/shuttles/mercenary1)
"aK" = (/obj/effect/floor_decal/borderfloor/corner,/turf/simulated/floor/tiled/steel,/area/submap/shuttles/mercenary1)
"aL" = (/obj/effect/floor_decal/borderfloor,/turf/simulated/floor/tiled/steel,/area/submap/shuttles/mercenary1)
"aM" = (/obj/machinery/light{dir = 4; icon_state = "tube1"; pixel_x = 0},/obj/effect/floor_decal/borderfloor{dir = 6},/turf/simulated/floor/tiled/steel,/area/submap/shuttles/mercenary1)
"aN" = (/obj/structure/table/standard,/obj/effect/floor_decal/corner/green/border{icon_state = "bordercolor"; dir = 10},/turf/simulated/floor/tiled/white,/area/submap/shuttles/mercenary1)
"aO" = (/obj/structure/table/standard,/obj/effect/floor_decal/corner/green/border,/turf/simulated/floor/tiled/white,/area/submap/shuttles/mercenary1)
"aP" = (/obj/effect/floor_decal/corner/green/border,/turf/simulated/floor/tiled/white,/area/submap/shuttles/mercenary1)
"aQ" = (/obj/structure/table/standard,/obj/item/clothing/gloves/sterile,/obj/item/clothing/gloves/sterile,/obj/effect/floor_decal/corner/green/border,/turf/simulated/floor/tiled/white,/area/submap/shuttles/mercenary1)
"aR" = (/obj/structure/table/standard,/obj/effect/floor_decal/corner/green/border{icon_state = "bordercolor"; dir = 6},/turf/simulated/floor/tiled/white,/area/submap/shuttles/mercenary1)
"aS" = (/obj/machinery/light{icon_state = "tube1"; dir = 8},/obj/effect/floor_decal/borderfloor{dir = 9},/turf/simulated/floor/tiled/steel,/area/submap/shuttles/mercenary1)
"aT" = (/obj/structure/bed/chair/office/dark{dir = 1},/obj/effect/floor_decal/borderfloor{dir = 5},/turf/simulated/floor/tiled/steel,/area/submap/shuttles/mercenary1)
"aU" = (/obj/machinery/door/airlock/security{locked = 1},/turf/simulated/floor/tiled/steel,/area/submap/shuttles/mercenary1)
"aV" = (/obj/machinery/door/airlock/glass,/turf/simulated/floor/tiled/white,/area/submap/shuttles/mercenary1)
"aW" = (/obj/machinery/computer/communications,/obj/effect/floor_decal/borderfloor{dir = 9},/turf/simulated/floor/tiled/steel,/area/submap/shuttles/mercenary1)
"aX" = (/obj/effect/floor_decal/borderfloor/corner{dir = 1},/turf/simulated/floor/tiled/steel,/area/submap/shuttles/mercenary1)
"aY" = (/obj/effect/floor_decal/borderfloor{dir = 9},/turf/simulated/floor/tiled/steel,/area/submap/shuttles/mercenary1)
"aZ" = (/obj/structure/closet/secure_closet/freezer/fridge,/turf/simulated/floor/tiled/steel,/area/submap/shuttles/mercenary1)
"ba" = (/obj/structure/table/steel,/turf/simulated/floor/tiled/steel,/area/submap/shuttles/mercenary1)
"bb" = (/turf/simulated/floor/tiled/steel,/area/submap/shuttles/mercenary1)
"bc" = (/obj/machinery/light{dir = 1},/turf/simulated/floor/tiled/steel,/area/submap/shuttles/mercenary1)
"bd" = (/obj/structure/table/steel,/obj/random/toolbox,/turf/simulated/floor/tiled/yellow,/area/submap/shuttles/mercenary1)
"be" = (/obj/structure/table/steel,/obj/machinery/light/small{dir = 4; pixel_y = 0},/obj/random/projectile/scrapped_gun,/obj/random/projectile/scrapped_gun,/turf/simulated/floor/tiled/yellow,/area/submap/shuttles/mercenary1)
"bf" = (/obj/structure/grille,/obj/structure/window/reinforced{dir = 1},/obj/structure/window/reinforced{dir = 8},/obj/structure/window/reinforced{dir = 4},/turf/simulated/floor/plating,/area/submap/shuttles/mercenary1)
"bg" = (/obj/structure/table/steel,/obj/effect/floor_decal/borderfloor{dir = 8},/turf/simulated/floor/tiled/steel,/area/submap/shuttles/mercenary1)
"bh" = (/obj/machinery/light{icon_state = "tube1"; dir = 8},/obj/effect/floor_decal/borderfloor{dir = 8},/turf/simulated/floor/tiled/steel,/area/submap/shuttles/mercenary1)
"bi" = (/obj/machinery/light{dir = 4; icon_state = "tube1"; pixel_x = 0},/obj/effect/floor_decal/borderfloor{dir = 4},/turf/simulated/floor/tiled/steel,/area/submap/shuttles/mercenary1)
"bj" = (/obj/structure/table/steel,/obj/random/projectile,/turf/simulated/floor/tiled/yellow,/area/submap/shuttles/mercenary1)
"bk" = (/obj/machinery/fusion_fuel_compressor,/turf/simulated/floor/tiled/yellow,/area/submap/shuttles/mercenary1)
"bl" = (/obj/structure/shuttle/engine/heater{icon_state = "heater"; dir = 4},/turf/simulated/shuttle/wall/dark,/area/submap/shuttles/mercenary1)
"bm" = (/obj/structure/grille,/obj/structure/window/reinforced{dir = 4},/obj/structure/window/reinforced{dir = 8},/turf/simulated/floor/plating,/area/submap/shuttles/mercenary1)
"bn" = (/obj/machinery/door/airlock/glass,/obj/effect/floor_decal/borderfloor{dir = 1},/turf/simulated/floor/tiled/steel,/area/submap/shuttles/mercenary1)
"bo" = (/obj/effect/floor_decal/corner/grey,/mob/living/simple_mob/mechanical/viscerator,/turf/simulated/floor/tiled/steel,/area/submap/shuttles/mercenary1)
"bp" = (/obj/machinery/door/airlock/glass,/turf/simulated/floor/tiled/steel,/area/submap/shuttles/mercenary1)
"bq" = (/mob/living/simple_mob/mechanical/viscerator,/turf/simulated/floor/tiled/steel,/area/submap/shuttles/mercenary1)
"br" = (/obj/structure/table/steel,/obj/item/pizzabox,/turf/simulated/floor/tiled/steel,/area/submap/shuttles/mercenary1)
"bs" = (/obj/machinery/door/airlock,/turf/simulated/floor/tiled/steel,/area/submap/shuttles/mercenary1)
"bt" = (/obj/structure/loot_pile/surface/bones,/turf/simulated/floor/tiled/steel,/area/submap/shuttles/mercenary1)
"bu" = (/obj/machinery/fusion_fuel_injector/mapped{icon_state = "injector0"; dir = 4},/turf/simulated/floor/tiled/yellow,/area/submap/shuttles/mercenary1)
"bv" = (/obj/machinery/door/airlock/glass,/obj/effect/floor_decal/borderfloor,/turf/simulated/floor/tiled/steel,/area/submap/shuttles/mercenary1)
"bw" = (/obj/effect/floor_decal/borderfloor/corner{dir = 8},/turf/simulated/floor/tiled/steel,/area/submap/shuttles/mercenary1)
"bx" = (/obj/structure/grille,/obj/structure/window/reinforced,/obj/structure/window/reinforced{dir = 8},/obj/structure/window/reinforced{dir = 4},/turf/simulated/floor/plating,/area/submap/shuttles/mercenary1)
"by" = (/obj/machinery/power/apc{dir = 8; name = "BSD APC"; pixel_x = -24},/turf/simulated/floor/tiled/yellow,/area/submap/shuttles/mercenary1)
"bz" = (/turf/simulated/floor/tiled/yellow,/area/submap/shuttles/mercenary1)
"bA" = (/obj/machinery/computer/area_atmos,/obj/effect/floor_decal/borderfloor{dir = 10},/turf/simulated/floor/tiled/steel,/area/submap/shuttles/mercenary1)
"bB" = (/obj/effect/floor_decal/borderfloor{dir = 10},/turf/simulated/floor/tiled/steel,/area/submap/shuttles/mercenary1)
"bC" = (/obj/effect/floor_decal/borderfloor{dir = 4},/obj/effect/floor_decal/borderfloor{dir = 4},/turf/simulated/floor/tiled/steel,/area/submap/shuttles/mercenary1)
"bD" = (/obj/machinery/light,/turf/simulated/floor/tiled/steel,/area/submap/shuttles/mercenary1)
"bE" = (/obj/structure/closet/toolcloset,/turf/simulated/floor/tiled/yellow,/area/submap/shuttles/mercenary1)
"bF" = (/obj/machinery/portable_atmospherics/canister/empty/oxygen,/turf/simulated/floor/tiled/yellow,/area/submap/shuttles/mercenary1)
"bG" = (/obj/machinery/atmospherics/pipe/tank/oxygen,/obj/machinery/light/small{dir = 4; pixel_y = 0},/turf/simulated/floor/tiled/yellow,/area/submap/shuttles/mercenary1)
"bH" = (/obj/machinery/light{icon_state = "tube1"; dir = 8},/obj/effect/floor_decal/borderfloor{dir = 10},/turf/simulated/floor/tiled/steel,/area/submap/shuttles/mercenary1)
"bI" = (/obj/structure/bed/chair/office/dark,/obj/effect/floor_decal/borderfloor{dir = 6},/turf/simulated/floor/tiled/steel,/area/submap/shuttles/mercenary1)
"bJ" = (/obj/effect/floor_decal/borderfloor/corner{dir = 4},/obj/effect/floor_decal/borderfloor/corner{dir = 4},/turf/simulated/floor/tiled/steel,/area/submap/shuttles/mercenary1)
"bK" = (/obj/machinery/light{dir = 4; icon_state = "tube1"; pixel_x = 0},/obj/effect/floor_decal/borderfloor{dir = 5},/turf/simulated/floor/tiled/steel,/area/submap/shuttles/mercenary1)
"bL" = (/obj/structure/bed,/turf/simulated/floor/tiled/steel,/area/submap/shuttles/mercenary1)
"bM" = (/obj/machinery/door/airlock,/turf/simulated/floor/tiled/hydro,/area/submap/shuttles/mercenary1)
"bN" = (/turf/simulated/floor/tiled/hydro,/area/submap/shuttles/mercenary1)
"bO" = (/mob/living/simple_mob/mechanical/viscerator,/turf/simulated/floor/tiled/steel_grid,/area/submap/shuttles/mercenary1)
"bP" = (/obj/effect/floor_decal/borderfloor{dir = 6},/turf/simulated/floor/tiled/steel,/area/submap/shuttles/mercenary1)
"bQ" = (/obj/structure/bed,/obj/structure/bed,/turf/simulated/floor/tiled/steel,/area/submap/shuttles/mercenary1)
"bR" = (/obj/machinery/light/small{dir = 4; pixel_y = 0},/turf/simulated/floor/tiled/hydro,/area/submap/shuttles/mercenary1)
"bS" = (/mob/living/simple_mob/mechanical/viscerator,/mob/living/simple_mob/mechanical/viscerator,/turf/simulated/floor/tiled/steel_grid,/area/submap/shuttles/mercenary1)
"bT" = (/obj/structure/toilet{dir = 1},/turf/simulated/floor/tiled/hydro,/area/submap/shuttles/mercenary1)
"bU" = (/obj/machinery/light,/obj/structure/table/rack,/obj/item/clothing/head/helmet/space,/obj/item/clothing/head/helmet/space,/obj/item/clothing/head/helmet/space,/obj/item/clothing/head/helmet/space,/obj/item/clothing/suit/space,/obj/item/clothing/suit/space,/obj/item/clothing/suit/space,/obj/item/clothing/suit/space,/obj/effect/floor_decal/borderfloor{dir = 10},/turf/simulated/floor/tiled/steel,/area/submap/shuttles/mercenary1)
"bV" = (/obj/structure/dispenser/oxygen,/obj/effect/floor_decal/borderfloor{dir = 6},/turf/simulated/floor/tiled/steel,/area/submap/shuttles/mercenary1)
"bW" = (/obj/structure/table/woodentable,/obj/random/projectile,/turf/simulated/floor/tiled/steel,/area/submap/shuttles/mercenary1)
"bX" = (/obj/structure/bed,/obj/machinery/light,/turf/simulated/floor/tiled/steel,/area/submap/shuttles/mercenary1)
"bY" = (/obj/structure/table/woodentable,/turf/simulated/floor/tiled/steel,/area/submap/shuttles/mercenary1)

(1,1,1) = {"
aaaaabababababababaaaaaaaaaaaaaaaaaaaaabababababababaa
aaaaabacacacacacabababababababababababacacacacacacabaa
aaaaabacacacacacacacacadaeaeadacacacacacacacacafagabaa
aaaaabacacacacacacahaiacajajacakalamanaoadacacafagabaa
aaaaababacacapaqacarasadatatadauavawaxayaxazacacacabaa
aaababacacacaAaBacaraCaDaDaEacauaFaFaGaxawaHacacababaa
ababacadaIacapaJacaraKaLaLaMacaNaOaxaPaQaOaRacabababaa
abacadaSaTacaUacadarasadacacacacacaVacacacacacacacabab
abacaWaXasacaYaDaDaXasacaZbabbbcbbbbbbacbdbdbeadacacab
abbfbgbbasadbhbbbbbbbiadbbbbbbbbbbbbbbacbjbbbbbkblagab
abbmbgbbaCbnaXbbbobbbbbpbbbqbrbababbbbbsbbbqbtbublagab
abbmbgbbaKbvbwbqbbbbbbbpbbbbbabababbbbbsbbbqbbbublagab
abbxbgbbasadbhbbbbbtbiadbbbbbbbbbbbtbbacbybbbbbzblagab
abacbAbwasadbBaLaLbwbCacbababbbDbbbbbbacbEbFbGadacacab
abacadbHbIacaUacadarasadacacacacacbpacacacacacacacabab
ababacadaIacapaJacarbJaDaDbKacbLbbbbbqbbbMbNacabababaa
aaababacacacbOaBacaraKaLaLbPacbQbbbLbbbLacbRacacababaa
aaaaababacacbSaJacarasadatatadbLbbbLbbbLacbTacacacabaa
aaaaabacacacacacacbUbVacajajacbLbWbXbYbLacacacafagabaa
aaaaabacacacacacacacacadaeaeadacacacacacacacacafagabaa
aaaaabacacacacacabababababababababababacacacacacacabaa
aaaaabababababababaaaaaaaaaaaaaaaaaaababababababababaa
"}
