"aa" = (/turf/template_noop,/area/template_noop)
"ab" = (/obj/effect/decal/cleanable/blood/oil,/turf/template_noop,/area/template_noop)
"ac" = (/turf/simulated/mineral/floor/ignore_mapgen/vacuum,/area/template_noop)
"ad" = (/obj/effect/decal/cleanable/blood/oil,/turf/simulated/mineral/floor/ignore_mapgen/vacuum,/area/template_noop)
"ae" = (/obj/item/clothing/head/cone,/turf/simulated/mineral/floor/ignore_mapgen/vacuum,/area/template_noop)
"af" = (/obj/effect/decal/cleanable/blood/oil,/obj/item/tape/medical{dir = 4; icon_state = "tape_dir_0"},/obj/item/tape/medical{dir = 2; icon_state = "tape_dir_0"},/turf/simulated/mineral/floor/ignore_mapgen/vacuum,/area/template_noop)
"ag" = (/obj/item/tape/medical{icon_state = "tape_h_0"},/turf/simulated/mineral/floor/ignore_mapgen/vacuum,/area/template_noop)
"ah" = (/obj/effect/decal/cleanable/blood/oil,/obj/item/tape/medical{icon_state = "tape_h_0"},/turf/simulated/mineral/floor/ignore_mapgen/vacuum,/area/template_noop)
"ai" = (/turf/simulated/shuttle/wall,/area/submap/shuttles/quarantine)
"aj" = (/obj/item/tape/medical{icon_state = "tape_v_0"},/turf/simulated/mineral/floor/ignore_mapgen/vacuum,/area/template_noop)
"ak" = (/obj/structure/inflatable,/turf/simulated/mineral/floor/ignore_mapgen/vacuum,/area/template_noop)
"al" = (/obj/structure/inflatable/door,/turf/simulated/mineral/floor/ignore_mapgen/vacuum,/area/template_noop)
"am" = (/turf/simulated/floor/outdoors/rocks/airless,/area/template_noop)
"an" = (/obj/effect/decal/cleanable/blood/oil,/turf/simulated/floor/outdoors/rocks/airless,/area/template_noop)
"ao" = (/obj/structure/shuttle/engine/heater{icon_state = "heater"; dir = 4},/turf/simulated/shuttle/plating,/area/submap/shuttles/quarantine)
"ap" = (/obj/structure/shuttle/engine/propulsion{icon_state = "propulsion_l"; dir = 8},/turf/simulated/shuttle/plating,/area/submap/shuttles/quarantine)
"aq" = (/obj/structure/grille,/obj/structure/shuttle/window,/obj/machinery/door/blast/regular{dir = 8; id = "QShuttlePoIDoors"; layer = 3.3; name = "Emergency Lockdown Shutters"},/obj/item/tape/medical{dir = 4; icon_state = "tape_door_0"; layer = 3.4},/turf/simulated/shuttle/plating,/area/submap/shuttles/quarantine)
"ar" = (/turf/simulated/shuttle/wall/hard_corner,/area/submap/shuttles/quarantine)
"as" = (/obj/machinery/door/airlock/external{desc = "It opens and closes. It is stamped with the logo of Major Bill's Transportation"; frequency = 1380; icon_state = "door_locked"; id_tag = null; locked = 1; name = "MBT-540"},/obj/item/tape/medical{dir = 4; icon_state = "tape_door_0"; layer = 3.4},/turf/simulated/shuttle/floor{icon_state = "floor_white"},/area/submap/shuttles/quarantine)
"at" = (/obj/structure/sign/biohazard{dir = 1},/turf/simulated/shuttle/wall/hard_corner,/area/submap/shuttles/quarantine)
"au" = (/obj/structure/toilet{dir = 4},/obj/effect/decal/cleanable/vomit,/obj/effect/decal/remains/human,/turf/simulated/shuttle/floor,/area/submap/shuttles/quarantine)
"av" = (/obj/machinery/door/airlock{name = "Restroom"},/turf/simulated/shuttle/wall,/area/submap/shuttles/quarantine)
"aw" = (/obj/effect/decal/cleanable/vomit,/turf/simulated/shuttle/floor{icon_state = "floor_white"},/area/submap/shuttles/quarantine)
"ax" = (/obj/effect/decal/remains/human,/obj/item/clothing/suit/space/emergency,/obj/item/clothing/head/helmet/space/emergency,/turf/simulated/shuttle/floor{icon_state = "floor_white"},/area/submap/shuttles/quarantine)
"ay" = (/obj/structure/bed/chair,/turf/simulated/shuttle/floor{icon_state = "floor_white"},/area/submap/shuttles/quarantine)
"az" = (/obj/structure/bed/chair,/obj/effect/decal/remains/human,/obj/item/clothing/suit/space/emergency,/turf/simulated/shuttle/floor{icon_state = "floor_white"},/area/submap/shuttles/quarantine)
"aA" = (/obj/machinery/vending/snack{contraband = null; products = list(/obj/item/weapon/reagent_containers/food/snacks/candy = 0, /obj/item/weapon/reagent_containers/food/drinks/dry_ramen = 0, /obj/item/weapon/reagent_containers/food/snacks/chips = 0, /obj/item/weapon/reagent_containers/food/snacks/sosjerky = 0, /obj/item/weapon/reagent_containers/food/snacks/no_raisin = 0, /obj/item/weapon/reagent_containers/food/snacks/spacetwinkie = 0, /obj/item/weapon/reagent_containers/food/snacks/cheesiehonkers = 0, /obj/item/weapon/reagent_containers/food/snacks/tastybread = 0, /obj/item/weapon/reagent_containers/food/snacks/skrellsnacks = 0)},/turf/simulated/shuttle/floor{icon_state = "floor_white"},/area/submap/shuttles/quarantine)
"aB" = (/obj/machinery/vending/cola{contraband = null; products = list(/obj/item/weapon/reagent_containers/food/drinks/cans/cola = 0, /obj/item/weapon/reagent_containers/food/drinks/cans/space_mountain_wind = 0, /obj/item/weapon/reagent_containers/food/drinks/cans/dr_gibb = 0, /obj/item/weapon/reagent_containers/food/drinks/cans/starkist = 0, /obj/item/weapon/reagent_containers/food/drinks/cans/waterbottle = 0, /obj/item/weapon/reagent_containers/food/drinks/cans/space_up = 0, /obj/item/weapon/reagent_containers/food/drinks/cans/iced_tea = 0, /obj/item/weapon/reagent_containers/food/drinks/cans/grape_juice = 0, /obj/item/weapon/reagent_containers/food/drinks/cans/gingerale = 0)},/turf/simulated/shuttle/floor{icon_state = "floor_white"},/area/submap/shuttles/quarantine)
"aC" = (/obj/structure/closet/crate/secure/loot,/turf/simulated/shuttle/floor{icon_state = "floor_yellow"},/area/submap/shuttles/quarantine)
"aD" = (/obj/item/weapon/pickaxe/drill,/turf/simulated/shuttle/floor{icon_state = "floor_yellow"},/area/submap/shuttles/quarantine)
"aE" = (/obj/item/clothing/mask/breath,/obj/effect/decal/cleanable/dirt,/turf/simulated/shuttle/floor{icon_state = "floor_white"},/area/submap/shuttles/quarantine)
"aF" = (/obj/effect/decal/cleanable/generic,/turf/simulated/shuttle/floor{icon_state = "floor_white"},/area/submap/shuttles/quarantine)
"aG" = (/obj/effect/decal/remains/xeno,/turf/simulated/shuttle/floor{icon_state = "floor_yellow"},/area/submap/shuttles/quarantine)
"aH" = (/obj/item/trash/syndi_cakes,/turf/simulated/shuttle/floor{icon_state = "floor_yellow"},/area/submap/shuttles/quarantine)
"aI" = (/turf/simulated/shuttle/floor{icon_state = "floor_yellow"},/area/submap/shuttles/quarantine)
"aJ" = (/obj/item/trash/cigbutt,/obj/item/weapon/tank/emergency/oxygen,/turf/simulated/shuttle/floor{icon_state = "floor_yellow"},/area/submap/shuttles/quarantine)
"aK" = (/obj/item/weapon/material/knife/tacknife/boot,/obj/item/clothing/mask/breath,/turf/simulated/shuttle/floor{icon_state = "floor_yellow"},/area/submap/shuttles/quarantine)
"aL" = (/obj/effect/decal/remains/human,/turf/simulated/shuttle/floor{icon_state = "floor_white"},/area/submap/shuttles/quarantine)
"aM" = (/obj/item/trash/sosjerky,/obj/item/weapon/storage/box/donut/empty,/obj/item/weapon/reagent_containers/food/drinks/sillycup,/turf/simulated/shuttle/floor{icon_state = "floor_white"},/area/submap/shuttles/quarantine)
"aN" = (/obj/structure/grille,/obj/structure/window/reinforced{dir = 1; health = 1e+006},/obj/structure/window/reinforced,/obj/structure/window/reinforced{dir = 8},/turf/simulated/shuttle/plating,/area/submap/shuttles/quarantine)
"aO" = (/obj/machinery/door/airlock/glass,/turf/simulated/shuttle/floor{icon_state = "floor_yellow"},/area/submap/shuttles/quarantine)
"aP" = (/obj/structure/grille,/obj/structure/window/reinforced{dir = 1; health = 1e+006},/obj/structure/window/reinforced{dir = 4},/turf/simulated/shuttle/plating,/area/submap/shuttles/quarantine)
"aQ" = (/obj/machinery/button{name = "Cargo Hatch"},/turf/simulated/shuttle/wall,/area/submap/shuttles/quarantine)
"aR" = (/obj/machinery/computer,/turf/simulated/shuttle/floor,/area/submap/shuttles/quarantine)
"aS" = (/obj/structure/bed/chair/comfy/brown{dir = 8},/obj/effect/decal/cleanable/vomit,/turf/simulated/shuttle/floor{icon_state = "floor_white"},/area/submap/shuttles/quarantine)
"aT" = (/turf/simulated/shuttle/floor,/area/submap/shuttles/quarantine)
"aU" = (/obj/item/trash/cheesie,/obj/effect/decal/remains/human,/turf/simulated/shuttle/floor{icon_state = "floor_white"},/area/submap/shuttles/quarantine)
"aV" = (/obj/effect/decal/cleanable/dirt,/turf/simulated/shuttle/floor{icon_state = "floor_yellow"},/area/submap/shuttles/quarantine)
"aW" = (/obj/structure/bed/chair{dir = 1},/obj/effect/decal/cleanable/dirt,/turf/simulated/shuttle/floor{icon_state = "floor_yellow"},/area/submap/shuttles/quarantine)
"aX" = (/obj/structure/bed/chair{dir = 1},/obj/effect/decal/remains/human,/obj/item/clothing/mask/breath,/turf/simulated/shuttle/floor{icon_state = "floor_white"},/area/submap/shuttles/quarantine)
"aY" = (/obj/structure/bed/chair{dir = 1},/turf/simulated/shuttle/floor{icon_state = "floor_white"},/area/submap/shuttles/quarantine)
"aZ" = (/obj/structure/bed/chair{dir = 1},/turf/simulated/shuttle/floor{icon_state = "floor_yellow"},/area/submap/shuttles/quarantine)
"ba" = (/obj/effect/decal/cleanable/vomit,/turf/simulated/shuttle/floor{icon_state = "floor_yellow"},/area/submap/shuttles/quarantine)
"bb" = (/obj/item/clothing/head/helmet/space/emergency,/turf/simulated/shuttle/floor{icon_state = "floor_white"},/area/submap/shuttles/quarantine)
"bc" = (/obj/machinery/door/airlock/engineering{icon_state = "door_locked"; locked = 1; name = "Cargo Bay"},/turf/simulated/shuttle/floor{icon_state = "floor_yellow"},/area/submap/shuttles/quarantine)
"bd" = (/obj/item/weapon/virusdish/random,/turf/simulated/shuttle/floor{icon_state = "floor_yellow"},/area/submap/shuttles/quarantine)
"be" = (/obj/item/weapon/material/shard,/turf/simulated/shuttle/floor{icon_state = "floor_yellow"},/area/submap/shuttles/quarantine)
"bf" = (/obj/item/device/paicard,/turf/simulated/shuttle/floor{icon_state = "floor_yellow"},/area/submap/shuttles/quarantine)
"bg" = (/obj/machinery/door/blast/regular{name = "Cargo Door"},/obj/item/tape/medical{dir = 4; icon_state = "tape_door_0"; layer = 3.4},/turf/simulated/shuttle/floor{icon_state = "floor_yellow"},/area/submap/shuttles/quarantine)
"bh" = (/obj/effect/decal/remains/human,/obj/item/clothing/under/mbill{desc = "A uniform belonging to Major Bill's Transportation, a shipping megacorporation. This looks at least a few decades out of date."; name = "\improper old Major Bill's uniform"},/obj/item/clothing/head/soft/mbill{desc = "It's a ballcap bearing the colors of Major Bill's Shipping. This one looks at least a few decades out of date."; name = "old shipping cap"},/turf/simulated/shuttle/floor,/area/submap/shuttles/quarantine)
"bi" = (/obj/item/trash/cigbutt,/turf/simulated/shuttle/floor{icon_state = "floor_white"},/area/submap/shuttles/quarantine)
"bj" = (/obj/machinery/door/airlock/command{icon_state = "door_locked"; locked = 1},/turf/simulated/shuttle/floor{icon_state = "floor_white"},/area/submap/shuttles/quarantine)
"bk" = (/obj/item/weapon/tank/emergency/oxygen/engi,/obj/effect/decal/cleanable/dirt,/turf/simulated/shuttle/floor{icon_state = "floor_white"},/area/submap/shuttles/quarantine)
"bl" = (/obj/effect/decal/remains/human,/obj/item/clothing/suit/space/emergency,/obj/item/clothing/head/helmet/space/emergency,/obj/effect/decal/cleanable/dirt,/turf/simulated/shuttle/floor{icon_state = "floor_yellow"},/area/submap/shuttles/quarantine)
"bm" = (/obj/structure/grille,/obj/structure/window/reinforced,/obj/structure/window/reinforced{dir = 8},/obj/structure/window/reinforced{dir = 1; health = 1e+006},/turf/simulated/shuttle/plating,/area/submap/shuttles/quarantine)
"bn" = (/obj/structure/grille,/obj/structure/window/reinforced,/obj/structure/window/reinforced{dir = 1; health = 1e+006},/turf/simulated/shuttle/plating,/area/submap/shuttles/quarantine)
"bo" = (/obj/structure/grille,/obj/structure/window/reinforced,/obj/structure/window/reinforced{dir = 4},/obj/structure/window/reinforced{dir = 1; health = 1e+006},/turf/simulated/shuttle/plating,/area/submap/shuttles/quarantine)
"bp" = (/obj/item/clothing/suit/space/emergency,/turf/simulated/shuttle/floor{icon_state = "floor_yellow"},/area/submap/shuttles/quarantine)
"bq" = (/obj/item/trash/candy,/obj/effect/decal/cleanable/dirt,/turf/simulated/shuttle/floor{icon_state = "floor_white"},/area/submap/shuttles/quarantine)
"br" = (/obj/structure/table/rack,/obj/structure/loot_pile/maint/boxfort,/turf/simulated/shuttle/floor{icon_state = "floor_yellow"},/area/submap/shuttles/quarantine)
"bs" = (/obj/structure/table/rack,/obj/item/weapon/shovel,/turf/simulated/shuttle/floor{icon_state = "floor_yellow"},/area/submap/shuttles/quarantine)
"bt" = (/obj/structure/closet/crate/secure/science{icon_state = "scisecurecrateopen"; locked = 0; name = "Virus Samples - FRAGILE"; opened = 1},/obj/item/weapon/virusdish/random,/obj/item/weapon/virusdish/random,/obj/item/weapon/virusdish/random,/turf/simulated/shuttle/floor{icon_state = "floor_yellow"},/area/submap/shuttles/quarantine)
"bu" = (/obj/structure/bed/chair/comfy/brown{dir = 8},/obj/effect/decal/remains/human,/obj/item/clothing/under/mbill{desc = "A uniform belonging to Major Bill's Transportation, a shipping megacorporation. This looks at least a few decades out of date."; name = "\improper old Major Bill's uniform"},/obj/item/clothing/head/soft/mbill{desc = "It's a ballcap bearing the colors of Major Bill's Shipping. This one looks at least a few decades out of date."; name = "old shipping cap"},/turf/simulated/shuttle/floor{icon_state = "floor_white"},/area/submap/shuttles/quarantine)
"bv" = (/obj/structure/table/standard,/obj/item/device/taperecorder,/turf/simulated/shuttle/floor,/area/submap/shuttles/quarantine)
"bw" = (/obj/item/weapon/tool/crowbar/red,/turf/simulated/shuttle/floor{icon_state = "floor_white"},/area/submap/shuttles/quarantine)
"bx" = (/obj/item/trash/chips,/obj/effect/decal/cleanable/dirt,/turf/simulated/shuttle/floor{icon_state = "floor_yellow"},/area/submap/shuttles/quarantine)
"by" = (/obj/structure/bed/chair,/turf/simulated/shuttle/floor{icon_state = "floor_yellow"},/area/submap/shuttles/quarantine)
"bz" = (/obj/structure/bed/chair,/obj/effect/decal/cleanable/dirt,/turf/simulated/shuttle/floor{icon_state = "floor_white"},/area/submap/shuttles/quarantine)
"bA" = (/obj/structure/bed/chair,/obj/effect/decal/remains/human,/obj/item/clothing/mask/breath,/obj/item/clothing/head/soft/mbill{desc = "It's a ballcap bearing the colors of Major Bill's Shipping. This one looks at least a few decades out of date."; name = "old shipping cap"},/turf/simulated/shuttle/floor{icon_state = "floor_white"},/area/submap/shuttles/quarantine)
"bB" = (/obj/structure/bed/chair,/obj/effect/decal/remains/human,/turf/simulated/shuttle/floor{icon_state = "floor_white"},/area/submap/shuttles/quarantine)
"bC" = (/obj/effect/decal/remains/xeno,/obj/effect/decal/cleanable/dirt,/turf/simulated/shuttle/floor{icon_state = "floor_white"},/area/submap/shuttles/quarantine)
"bD" = (/obj/item/weapon/material/shard{icon_state = "medium"},/turf/simulated/shuttle/floor{icon_state = "floor_yellow"},/area/submap/shuttles/quarantine)
"bE" = (/obj/effect/decal/remains/mouse,/turf/simulated/shuttle/floor{icon_state = "floor_yellow"},/area/submap/shuttles/quarantine)
"bF" = (/obj/random/maintenance,/turf/simulated/shuttle/floor{icon_state = "floor_yellow"},/area/submap/shuttles/quarantine)
"bG" = (/obj/item/weapon/coin/silver,/turf/simulated/shuttle/floor{icon_state = "floor_white"},/area/submap/shuttles/quarantine)
"bH" = (/obj/effect/decal/remains/human,/obj/item/clothing/suit/space/emergency,/obj/item/clothing/head/helmet/space/emergency,/turf/simulated/shuttle/floor{icon_state = "floor_yellow"},/area/submap/shuttles/quarantine)
"bI" = (/obj/effect/decal/cleanable/generic,/turf/simulated/shuttle/floor{icon_state = "floor_yellow"},/area/submap/shuttles/quarantine)
"bJ" = (/obj/item/weapon/tank/emergency/oxygen/engi,/turf/simulated/shuttle/floor{icon_state = "floor_yellow"},/area/submap/shuttles/quarantine)
"bK" = (/obj/item/trash/sosjerky,/obj/effect/decal/remains/human,/turf/simulated/shuttle/floor{icon_state = "floor_white"},/area/submap/shuttles/quarantine)
"bL" = (/obj/effect/decal/remains/human,/obj/item/clothing/mask/breath,/turf/simulated/shuttle/floor{icon_state = "floor_white"},/area/submap/shuttles/quarantine)
"bM" = (/obj/structure/grille,/obj/structure/window/reinforced,/obj/structure/window/reinforced{dir = 8},/obj/structure/window/reinforced{dir = 1},/turf/simulated/shuttle/plating,/area/submap/shuttles/quarantine)
"bN" = (/obj/structure/grille,/obj/structure/window/reinforced,/obj/structure/window/reinforced{dir = 4},/obj/structure/window/reinforced{dir = 1},/turf/simulated/shuttle/plating,/area/submap/shuttles/quarantine)
"bO" = (/obj/machinery/button{dir = 4; name = "Cargo Access"},/turf/simulated/shuttle/wall,/area/submap/shuttles/quarantine)
"bP" = (/obj/machinery/recharge_station,/turf/simulated/shuttle/floor,/area/submap/shuttles/quarantine)
"bQ" = (/obj/machinery/door/airlock{name = "Charge Station"},/turf/simulated/shuttle/wall,/area/submap/shuttles/quarantine)
"bR" = (/obj/item/trash/tastybread,/obj/item/weapon/material/butterfly/boxcutter,/obj/effect/decal/cleanable/dirt,/turf/simulated/shuttle/floor{icon_state = "floor_white"},/area/submap/shuttles/quarantine)
"bS" = (/obj/effect/decal/cleanable/vomit,/obj/effect/decal/cleanable/mucus/mapped,/turf/simulated/shuttle/floor{icon_state = "floor_white"},/area/submap/shuttles/quarantine)
"bT" = (/obj/structure/bed/chair{dir = 1},/obj/effect/decal/remains/xeno,/turf/simulated/shuttle/floor{icon_state = "floor_white"},/area/submap/shuttles/quarantine)
"bU" = (/obj/structure/bed/chair{dir = 1},/obj/item/weapon/card/id/external{desc = "An identification card of some sort. Looks like this one was issued by the Vir Independent Mining Corp."; name = "VIMC identification card"; rank = "Miner"; registered_name = "Nadia Chu"},/turf/simulated/shuttle/floor{icon_state = "floor_white"},/area/submap/shuttles/quarantine)
"bV" = (/obj/structure/table/rack,/obj/item/weapon/storage/toolbox/emergency,/turf/simulated/shuttle/floor{icon_state = "floor_white"},/area/submap/shuttles/quarantine)
"bW" = (/obj/structure/table/rack,/obj/item/clothing/head/soft/mbill{desc = "It's a ballcap bearing the colors of Major Bill's Shipping. This one looks at least a few decades out of date."; name = "old shipping cap"},/turf/simulated/shuttle/floor{icon_state = "floor_white"},/area/submap/shuttles/quarantine)
"bX" = (/obj/structure/ore_box,/turf/simulated/shuttle/floor{icon_state = "floor_yellow"},/area/submap/shuttles/quarantine)
"bY" = (/obj/item/weapon/contraband/poster,/turf/simulated/shuttle/floor{icon_state = "floor_yellow"},/area/submap/shuttles/quarantine)
"bZ" = (/obj/structure/loot_pile/maint/technical,/turf/simulated/shuttle/floor{icon_state = "floor_yellow"},/area/submap/shuttles/quarantine)
"ca" = (/obj/structure/sign/biohazard,/turf/simulated/shuttle/wall/hard_corner,/area/submap/shuttles/quarantine)
"cb" = (/obj/item/taperoll/medical,/turf/simulated/mineral/floor/ignore_mapgen/vacuum,/area/template_noop)
"cc" = (/obj/item/tape/medical{dir = 1; icon_state = "tape_dir_0"},/obj/item/tape/medical{dir = 4; icon_state = "tape_dir_0"},/turf/simulated/mineral/floor/ignore_mapgen/vacuum,/area/template_noop)
"cd" = (/obj/item/tape/medical{icon_state = "tape_h_0"},/obj/effect/decal/cleanable/blood/oil,/turf/simulated/mineral/floor/ignore_mapgen/vacuum,/area/template_noop)

(1,1,1) = {"
aaaaaaaaaaaaaaaaaaaaabaaaaaaaaaaaaaaaaaaaaaaaaaaaa
aaaaabaaaaaaaaaaaaaaaaaaaaaaaaaaaaaaaaaaaaaaaaaaaa
aaaaaaaaaaabaaaaaaabaaaaaaaaaaaaabaaaaaaaaabaaaaaa
aaaaaaaaaaaaaaaaaaaaaaabaaacacacacacacadacaaaaaaaa
aaabaaaaacacacadacacacacacacacaeacacacadacacacacaa
aaaaaaacafagagagagagagahagagagagagagagagaiaiaiaeaa
aaacacacajacakalakakacacamanamacadacacacaiaoapacaa
aaaeacacaiaqarasasataqaiaqaiaiaiaiaiaiaiaiaiaiamaa
aaacacaiaiauavawaxaiayayazaiaAaBaiaCaDaCaiaoapanaa
aaamaiaiaiaiaiaEaFaGaHaIaJaKaLaMaiaNaOaPaiaQaiacaa
aaamaqaRaSaTaiaUaVaWaXaYaYaZbabbbcbdaIbebfaIbgacaa
aaacaqbhbibibjbkblaibmbnboaibpbqaibraIbsaIbtbgacaa
aaacaqaRbubvaibwbxbybzbAbBbyaVbCbcbDaIbEbdbFbgadaa
aaacaiaiaiaiaiaLbGaIbHaIbIbJbKbLaibMaObNaiaibOacaa
aaacacaiaibPbQbRbSaibTaYbUaibVbWaibXbYbZaiaoapacaa
acacaeacaiaqarasascaaqaiaqaiaiaiaiaiaiaiaiaiaiabaa
acadacadajacakakalakacacacaccbacacacacacaiaoapaaaa
aaacacacccagagagagagagagagagagagagagagcdaiaiaiaaab
aaaaacadacacacacacacacacacacadacacacacacacacadaaaa
aaaaaeacacacacacacacadacacamamamamacacacacacacaaaa
aaaaaaacacacadadacacacamamamamamamamamaaacacaeaaaa
aaaaaaaaaaaaaaaaaaaaaaaaamamamanaaaaaaaaaaaaaaaaaa
aaaaaaaaaaaaaaaaaaabaaaaaaaaaaaaaaaaaaaaaaaaaaaaaa
aaaaaaaaaaaaaaaaaaaaaaaaaaaaaaaaaaaaaaaaaaaaaaaaaa
aaaaaaaaaaaaaaaaaaaaaaaaaaaaaaaaaaaaaaaaaaaaaaaaaa
"}
