"a" = (/turf/template_noop,/area/template_noop)
"b" = (/turf/simulated/mineral/vacuum,/area/submap/asteroid/large3)
"c" = (/turf/simulated/mineral/floor/vacuum,/area/submap/asteroid/large3)

(1,1,1) = {"
aaaaaaaaaaaaaaaaaaaaaaaaaaaaaaaaaaaaaaaaaaa
aaaaaaaaabbbbbbbbbaaaaaaaaaaaaaaaaaaaaaaaaa
aaaaaabbbbbbbbbbbbbbbaaaaaaaaaaaaaaaaaaaaaa
aaaabbbbbbbbbbbbbbbbbbbbaaaaaaaaaaaaaaaaaaa
aaabbbbbbbbbbbbbbbbbbbbbbaaaaaaaaaaaaaaaaaa
aabbbbbbbbbbbbbbbbbbbbbbbbbaaaaaaaaaaaaaaaa
aabbbbbbbbbbbbbbbbbcbbbbbbbbbaaaaaaaaaaaaaa
aabbbbbbbbbbbbccbcbccbbbbbbbbbbaaaaaaaaaaaa
aaabbbbbbbbbbbbcbcbccbbbbbbbbbbbaaaaaaaaaaa
aaaabbbbbbbbbbbccccccccbbbbbbbbbbaaaaaaaaaa
aaaaabbbbbbbbbbbbbccccccbbbbbbbbbbaaaaaaaaa
aaaaaabbbbbbbbbbbcccccccbbbbbbbbbbbaaaaaaaa
aaaaaaabbbbbbbbbbbcccccccbbbbbbbbbbbaaaaaaa
aaaaaaaaabbbbbbbbbbbbcccccbbbbbbbbbbbaaaaaa
aaaaaaaaaabbbbbbbbbbbbbccccbbbbbbbbbbbaaaaa
aaaaaaaaaaabbcbbbbbbbbbbcccbbbbbbbbbbbaaaaa
aaaaaaaaaaaaacbcbbbbbbbbbbcbbbbbbbbbbbbaaaa
aaabbbbbaaaaaabbbbbbbbbbbbcccbbbbbbbbbbbaaa
aaabbbbbbbaaaaaabbbbbbbbbbbbccccbbbbbbbbaaa
abbbbbbbbbbcaaaaabbbccbbbbbbbbbcccbbbbbbbaa
abbbbbbbbbbccaaaaabbbccbbbbbbbbcccccbbbbbaa
abbbbbbbbbbbccaaaaaabbcccbbbbbbbcbbcbbbbbba
abbbbbbbbbbbcccaaaaabbbbcbbbbbbbbbbcbbbbbba
abbbbbbbbbbbccccaaaaaabbbbbbbbbbbbbbbbbbbba
abbbbbbbbbbbcccccaaaaaabbbbbbbbbbbbbbbbbbaa
aabbbbbbbbbcccccccaaaaaaabbbbbbbbccccccbbaa
aaaabbbbcccccccccccaaaaaaaabbbbcccccccccaaa
aaaaacccccccccccbbbaaaaaaaaaabbbcccccccaaaa
aaaaaaccccccccbbbbbbaaaaaaaaaaaaaccccaaaaaa
aaaaaaaaacccccbbbbbbaaaaaaaaaaaaaaaaaaaaaaa
aaaaaaaaaaaaccbbbbbbaaaaaaaaaaaaaaaaaaaaaaa
aaaaaaaaaaaaaaabbbbaaaaaaaaaaaaaaaaaaaaaaaa
aaaaaaaaaaaaaaaaaaaaaaaaaaaaaaaaaaaaaaaaaaa
"}
