"a" = (/turf/template_noop,/area/space)
"b" = (/turf/simulated/mineral/vacuum,/area/submap/asteroid/small5)

(1,1,1) = {"
aaaaaaaaaa
abbbbaaaaa
aabbbbbaaa
aabbbbbbaa
abbbbbbbba
abbbbbbbba
aabbbbbbaa
aaabbbbbaa
aaaaabbbba
aaaaaaaaaa
"}
