"a" = (/turf/template_noop,/area/template_noop)
"b" = (/turf/simulated/mineral/vacuum,/area/submap/asteroid/large7)

(1,1,1) = {"
aaaaaaaaaaaaaaaaaaaaaaaaaaaaaaaaaaaaaaa
aaaaaaaaaaaabbbbbbaaaaaaaaaaaaaaaaaaaaa
aaaaaaaaaabbbbbbbbbbaaaaaaaaaaaaaaaaaaa
aaaaaaaaabbbbbbbbbbbbbbbbbaaaaaaaaaaaaa
aaaaaaaabbbbbbbbbbbbbbbbbbbbbbbbbbbaaaa
aaaaaabbbbbbbbbbbbbbbbbbbbbbbbbbbbbbaaa
aaaabbbbbbbbbbbbbbbbbbbbbbbbbbbbbbbbbaa
aaaabbbbbbbbbbbbbbbbbbbbbbbbbbbbbbbbbba
aaabbbbbbbbbbbbbbbbbbbbbbbbbbbbbbbbbbba
abbbbbbbbbbbbbbbbbbbbbbbbbbbbbbbbbbbbba
abbbbbbbbbbbbbbbbbbbbbbbbbbbbbbbbbbbbba
abbbbbbbbbbbbbbbbbbbbbbbbbbbbbbbbbbbbaa
abbbbbbbbbbbbbbbbbbbbbbbbbbbbbbbbbbbaaa
abbbbbbbbbbbbbbbbbbbbbbbbbbbbbbbbbaaaaa
aabbbbbbbbbbbbbbbbbbbbbbbbbbbbbbaaaaaaa
aabbbbbbbbbbbbbbbbbbbbbbbbbbbbbbaabbbaa
aabbbbbbbbbbbbbbbbbbbbbbbbbbbbbaabbbbba
aaabbbbbbbbbbbbbbbbbbbbbbbbbbbaaabbbbba
aaaaabbbbbbbbbbbbbbbbbbbbbbbbaaaabbbbba
aaaaaabbbbbbbbbbbbbbbbbbbbbbbaaaaabbbba
aaaaaaaabbbbbbbbbbbbbbbbbbbaaaaaaaabbaa
aaaaaaaaaaabbbbbbbbbbbaaaaaaaaaaaaaaaaa
aaaaaaaaaaaaaaaaaaaaaaaaaaaaaaaaaaaaaaa
"}
