"a" = (/turf/template_noop,/area/template_noop)
"b" = (/turf/simulated/mineral/vacuum,/area/submap/asteroid/large0)

(1,1,1) = {"
aaaaaaaaaaaaaaaaaaaaaaaaaaaaaaaaaaaaaaaaaaa
aaaaaabaaaaaaaaaaaaaaaaaaaaaaaababaaaaaaaaa
aaaaaabbbbabaaaaaaaaaabbbaaaaaabbbbaaaaaaaa
aaaaabbbbbbbbaaabbaaabbbbbaaaaabbbbaaaaaaaa
aaaaabbbbbbbbbabbbbabbbbbbbaaaabbbaaaaaaaaa
aaabbbbbbbbbbbbbbbbbbbbbbbbbaaaabaaaaaaaaaa
aaaabbbbbbbbbbbbbbbbbbbbbbbbaaaaaaaaaaaaaaa
aaaaabbaaabbbbbbbbbbbbbbbbbbaaaaaaaaaaaaaaa
aababbbbaabbbbbbbbbbbbbbbbbbbaaaaaabbbbaaaa
abbbbbbbbabbbbbbbbbbbbbbbbbbbaaaaabbbbbbbaa
abbbbbbbbabbbbbbbbbbbbbbbbbbbbaaabbbbbbbbba
aabbbbbbbbbbbbbbbbbbbbbbbbbbbbaabbbbbbbbbaa
abbbbbbbbbbbbbbbbbbbbbbbbbbbbaaabbbbbbbbaaa
abbbbbbbbbbbbbbbbbbbbbbbbbbbaaabbbbbbbaaaaa
aaabbbbbbaabbbbbbbbbbbbbbbbbbbbbbbbbaaaaaaa
aaaaaaaaaaaabbbbbbbbbbbbbbbbbbbbbbbbaaaaaaa
aaaaaaaaaaaaaabbbbbbbbbbbbbbbbbbbbbaaaaaaaa
aaaaaaaaaaaaaaaabbbbbbbbbbbbbbbbaaaaaaaaaaa
aaaaaabbaaaaaaaaaabbbbbbbbbbbbbaaaaaaaaaaaa
aaabbbbbbbbaaaaaaaaabbbbbbbbbaaaaaaaaaaaaaa
aaaaabbbbbbbbaaaaaaaaabbbbbbaaaaaaaaaaaaaaa
aaaaaaaaabbaaaaaaaaaaabbbbaaaaaaaaaaaaaaaaa
aaaaaaaaaaaaaaaaaaaaaaaaaaaaaaaaaaaaaaaaaaa
"}
