"a" = (/turf/template_noop,/area/space)
"b" = (/turf/simulated/mineral/vacuum,/area/submap/asteroid/small3)

(1,1,1) = {"
aaaaaaaaaa
aaabbbaaaa
aabbbbbaaa
aabbbbbbaa
abbbbbbbba
abbbbbbbba
abbbbbbbba
abbbbbbbba
aabbbbbbaa
aaaaaaaaaa
"}
