"a" = (/turf/template_noop,/area/space)
"b" = (/turf/simulated/mineral/vacuum,/area/submap/asteroid/small8)

(1,1,1) = {"
aaaaaaaaaa
aaabbbbbaa
aabbbbbbaa
aabbbbbbaa
aaabbbbaaa
aaaaaaaaaa
aabbbbbaaa
abbbbbbaba
abbbbbaaba
aaaaaaaaaa
"}
