"a" = (/turf/template_noop,/area/template_noop)
"b" = (/turf/simulated/mineral/vacuum,/area/submap/asteroid/large1)
"c" = (/turf/simulated/mineral/floor/vacuum,/area/submap/asteroid/large1)

(1,1,1) = {"
aaaaaaaaaaaaaaaaaaaaaaaaaaaaaaaaaaaaaaaa
aaaaaaaaaaaaaaaaaaaaaaaaaaaaaaaaaaaaaaaa
aaaaaaaaaaaaaabbbbbbaaaaaaaaaaaaaaaaaaaa
aaaaaaabbbbbabbbbbbbbbaaaaaaaaaaaaabbaaa
aaaaaabbbbbbbbbbbbbbbbbaaaaaaaaaaaabbbaa
aaaaaabbbbbbbbbbbbbbbbbaaabbbbaaaaabbbaa
aaaaaabbbbbbbbbbbbbbbbbaabbbbbbaaaabbbaa
aaaaaabbbbbbbbbbbbbbbbbabbbbbbbaaaaabbaa
aaaaabbbbbbbbbbbccbbbbbbbbbbbbbaaaaaaaaa
aaaaabbbbbbbbbbccccbbbbbbbbbbaaaaaaaaaaa
aaaabbbbbbbbbbbcccccbbbbbbbbaaaaaaaaaaaa
aaaabbbbbbbbbbcccccaaaaabbcccccccaaaaaaa
aaaabbbbbbbbbcccccaaaaaabbccccccccaaaaaa
aaaaabbbbbbbbcccbbaaaaabbbbbbccbcccbaaaa
aaaaaabbbbbbccbbbbaaabbbbbbbbbbbbbbbbaaa
aaaaaaacccccccbbbbaaabbbbbbbbbbbbbbbbbaa
aaabbbbbbbbbbcbbbbaaabbbbbbbbbbbbbbbbbba
abbbbbbbbbbbccbbbbbbaabbbccbbbbbbbbbbbba
abbbbbbbbbbbcbbbbbbbbaaccccccbbbbbbbbbaa
abbbbbbbbbbccbbbbbbbbaaabbbccbbbbbbbbbaa
aabbbbbbbbccbbbbbbbbbaaaabbbbbbbbbbbbaaa
aaabbbbbbccccbbbbbbbbaaaaabbbbbbbbbbbaaa
aaabbbbbbcccccbbbbbbbaaaaaaabbbbbbbaaaaa
aaabbbbbccccccbbbbbbbbaaaaaaaaabbbbaaaaa
aaabbbbbbccccbbbbbbbbbaabbbaaabbbbaaaaaa
aababbbbbbbbbbbbbbbbbbbbbbbbbbbbbbaaaaaa
aabbbbbbbbbbbbbbbbbbbbbbbbbbbbbbbbaaaaaa
aabbabbbbbbbbbbbbbbbabbbbbbbbbbbbaaaaaaa
aaababbbbbbbbbbbbaaaaabbbbbbbbbbbaaaaaaa
aaaaaabbbbbbbbbbbaaaaaabbbbbbbbbbaaaaaaa
aaaaaabbbbbbbbbbaaaaaaabbbbbbbbbaaaaaaaa
aaaaaaaaaaaaaaaaaaaaaaaaabbbbbbbbaaaaaaa
aaaaaaaaaaaaaaaaaaaaaaaaaaabbbbaaaaaaaaa
aaaaaaaaaaaaaaaaaaaaaaaaaaaaaaaaaaaaaaaa
aaaaaaaaaaaaaaaaaaaaaaaaaaaaaaaaaaaaaaaa
"}
