"a" = (/turf/template_noop,/area/template_noop)
"b" = (/turf/simulated/mineral/vacuum,/area/submap/asteroid/large6)

(1,1,1) = {"
aaaaaaaaaaaaaaaaaaaaaaaaaaaaaaaaaaaaaa
aaaaaabbbaaaaaaaaaaaaaaaaaaaaaaabbbaaa
aaabbbbbbbbbbbaaaaaaaaaaaaabbaaabbbaaa
aabbbbbbbbbbbbbbbaaaaaaaaabbbaaabbbbaa
abbbbbbbbbbbbbbbbbbbbbaaaabbbaaabbbbaa
abbbbbbbbbbbbbbbbbbbbbbaaaabbaabbbbbaa
abbbbbbbbbbbbbbbbbbbbbbaaaaaaaabbbbbaa
abbbbbbbbbbbbbbbbbbbbbbaaaaaaaabbbbaaa
abbbbbbbbbbbbbbbbbbbbbbaaaaaaaaaaaaaaa
aabbbbbbbbbbbbbbbbbbbbaaaaaaaaaaaaaaaa
aaaabbbbbbbbbbbaaaaaaaaabbbbbbbbbbaaaa
aaaaaaaaabbbbbaaaaaaaaabbbbbbbbbbbbaaa
aaaaaaaaaaaaaaaaaaabbbbbbbbbbbbbbbbbba
aaaaaaaaaaaaaaaabbbbbbbbbbbbbbbbbbbbba
aaaaaaaaaaaabbbbbbbbbbbbbbbbbbbbbbbbba
aaaabbbaaaabbbbbbbbbbbbbbbbbbbbbbbbbba
aabbbbbbbaabbbbbbbbbbbbbbbbbbbbbbbbbaa
abbbbbbbbaabbbbbbbbbbbbbbbbbbbbbbbbaaa
abbbbbbbbbabbbbbbbbbbbbbbbbbbbbbbbaaaa
abbbbbbbbbabbbbbbbbbbbbbbbbbbbbbbbaaaa
abbbbbbbbaaabbbbbbbbbbbbbbbbbbbbbbaaaa
abbbbbbbaaaaaabbbbbbbbbbbbbbbbbbaaaaaa
aaabbbaaaaaaaaaaaabbbbbbbbbbbbaaaaaaaa
aaaaaaaaaaaaaaaaaaaaaaaaaaaaaaaaaaaaaa
"}
