"a" = (/turf/template_noop,/area/template_noop)
"b" = (/turf/simulated/mineral/vacuum,/area/submap/asteroid/large4)

(1,1,1) = {"
aaaaaaaaaaaaaaaaaaaaaaaaaaaaaaaaaaaaaaaa
aaaaaaaaaaaaaabbbbbbbbbbbbbbbbaaaaaaaaaa
aaaaaaaaaabbbbbbbbbbbbbbbbbbbbbbbaaaaaaa
aaaaaaaabbbbbbbbbbbbbbbbbbbbbbbbbbbaaaaa
aaaaaabbbbbbbbbbbbbbbbbbbbbbbbbbbbbbbaaa
aaaaabbbbbbbbbbbbbbbbbbbbbbbbbbbbbbbbbaa
aaaaabbbbbbbbbbbbbbbbbbbbbbbbbbbbbbbbbaa
aaaaabbbbbbbbbbbbbbbbbbbbbbbbbbbbbbbbbba
aaaabbbbbbbbbbbbbbbbbbbbbbbbbbbbbbbbbbba
aaaabbbbbbbbbbbbbbbbbbbbbbbbbbbbbbbbbbba
aaabbbbbbbbbbbbbbbbbbbbbbbbbbbbbbbbbbbba
aaabbbbbbbbbbbbbbbbbbbbbbbbbbbbbbbbbbbba
aaabbbbbbbbbbbbbbbbbbbbbbbbbbbbbbbbbbbba
aaaabbbbbbbbbbbbbbbbbbbbbbbbbbbbbbbbbbaa
aaaabbbbbbbbbbbbbbbbbbbbbbbbbbbbbbbbbaaa
aaaabbbbbbbbbbbbbbbbbbbbbbbbbbbbbbbaaaaa
aaaaabbbbbbbbbbbbbbbbbbbbbbbbbbbbbaaaaaa
aaaaabbbbbbbbbbbbbbbbbbbbbbbbbbbbbaaaaaa
aaaaaabbbbbbbbbbbbbbbbbbbbbbbbbbbaaaaaaa
aabbaabbbbbbbbbbbbbbbbbbbbbbbbbbbaaaaaaa
abbbbabbbbbbbbbbbbbbbbbbbbbbbbbbaaaaaaaa
abbbbaabbbbbbbbbbbbbbbbbbbbbbbbbaaaaaaaa
abbbbaabbbbbbbbbbbbbbbbbbbbbbbbbaaaaaaaa
aabbaaabbbbbbbbbbbbbbbbbbbbbbbbbbaaaaaaa
aaaaaabbbbbbbbbbbbbbbbbbbbbbbbbbbbaaaaaa
aaaaabbbbbbbbbbbbbbbbbbbbbbbbbbbbbaaaaaa
aaaabbbbbbbbbbbbbbbbbbbbbbbbbbbbbbaaaaaa
aaabbbbbbbbbbbbbbbbbbbbbbbbbbbbbbbaaaaaa
aaabbbbbbbbbbbbbbbbbbbbbbbbbbbbbbbaaaaaa
aaabbbbbbbbbbbbbbbbbbbbbbbbbbbbbaaaaaaaa
aaabbbbbbbbbbbbbbbbbbbbbbbbbbbbbaaaaaaaa
aaabbbbbbbbbbbbbbbbbbbbbbbbbbbbaaaaaaaaa
aaaabbbbbbbbbbbbbbbbbbbbbbbbbbbaaaaaaaaa
aaaaabbbbbbbbbbbbbbbbbbbbbbbbbaaaaaaaaaa
aaaaaaaabbbbbbbbbbbbbbbbbbbbaaaaaaaaaaaa
aaaaaaaaaaaaaaabbbbbbbbbbaaaaaaaaaaaaaaa
aaaaaaaaaaaaaaaaaaaaaaaaaaaaaaaaaaaaaaaa
"}
