"a" = (/turf/template_noop,/area/submap/lost_wallet)
"b" = (/obj/item/storage/wallet/random,/turf/template_noop,/area/submap/lost_wallet)
"c" = (/obj/item/coin/silver,/turf/template_noop,/area/submap/lost_wallet)

(1,1,1) = {"
aaaaa
aaaaa
aabaa
aacaa
aaaaa
"}
